[CHOREOGRAPHY] BTS (방탄소년단) 'Dynamite' Dance Practice	CN4fffh7gmk
[CHOREOGRAPHY] BTS (방탄소년단) 2018 MAMA Performance Practice (Formation Check ver.) #2020BTSFESTA	j6Ukt6x-cXI
[CHOREOGRAPHY] BTS (방탄소년단) Rehearsal Stage CAM 'Dionysus' @ SY IN SEOUL #2020BTSFESTA	G63Dsch0sEM
[CHOREOGRAPHY] BTS (방탄소년단) ‘ON’ Dance Practice (Fix ver.)	LpLPoRs3mlk
[CHOREOGRAPHY] BTS (방탄소년단) ‘ON’ Dance Practice	VkuEzN8IS_o
[CHOREOGRAPHY] BTS (방탄소년단) 'Black Swan' Dance Practice	fTS1jAhWPbw
[CHOREOGRAPHY] BTS (방탄소년단) 2019 MMA 'Dionysus' Dance Practice	bccr1BwNI0Y
[CHOREOGRAPHY] BTS (방탄소년단) 2019 MMA 'Dionysus' Intro Performance Dance Practice	GYs4bRYZxIA
[CHOREOGRAPHY] BTS (방탄소년단) '봄날 (Spring Day)' Dance Practice (Lovely ver.) #2019BTSFESTA	8ZbPyzh3pio
[CHOREOGRAPHY] BTS (방탄소년단) 'MIC Drop' Dance Practice (MAMA dance break ver.) #2019BTSFESTA	eRkpkveBWyo
[CHOREOGRAPHY] BTS (방탄소년단) 'Dionysus' Dance Practice	QmgcyLozkbQ
[CHOREOGRAPHY] BTS (방탄소년단) '작은 것들을 위한 시 (Boy With Luv)' Dance Practice	CzvfbRbEjww
[CHOREOGRAPHY] BTS (방탄소년단) 'IDOL' Dance Practice	bhWXw56puNY
[CHOREOGRAPHY] BTS (방탄소년단) Rehearsal Stage CAM 'Best of Me' @ 4TH MUSTER #2018BTSFESTA	RIJtfWu0b_w
[CHOREOGRAPHY] BTS (방탄소년단) 'Golden Disk Awards 2018' Dance Practice #2018BTSFESTA	6tJP3Y0QhV4
[CHOREOGRAPHY] BTS (방탄소년단) 'FAKE LOVE' Dance Practice	nQySbNGu4g0
[CHOREOGRAPHY] BTS (방탄소년단) 'DNA' Dance Practice	GEIU_7v40Dw
[CHOREOGRAPHY] BTS (방탄소년단) '좋아요 Part 2' Dance Practice	u2XBh23upio
[CHOREOGRAPHY] BTS (방탄소년단) 'Not Today' Dance Practice	_PwYjNh1bww
[CHOREOGRAPHY] BTS (방탄소년단) '봄날 (Spring Day)' Dance Practice	_AlODdAInRY
[CHOREOGRAPHY] BTS (방탄소년단) '피 땀 눈물 (Blood Sweat & Tears)' Dance Practice	v8z1TtlY1no
[CHOREOGRAPHY] BTS (방탄소년단) 정국이랑 지민이 ('Own it' choreography by Brian puspose) Dance practice	HMprwPSFLyU
[CHOREOGRAPHY] BTS (방탄소년단) j-hope Dance Practice for 2015 Begins Concert	dj42sqcbnCg
[CHOREOGRAPHY] BTS (방탄소년단) '불타오르네 (FIRE)' Dance Practice	sWuYspuN6U8
[CHOREOGRAPHY] BTS (방탄소년단) '쩔어' Dance Practice	NnbIIXNPtPU
방탄소년단 STAGE #TOMORROW @ THE RED BULLET IN SEOUL Dress Rehearsal	neOdZM9WqI0
방탄소년단-BTS- Special choreography Stage #2. 이불킥(Embarrassed) for 2015 FESTA	Cvz-50w3IiE
[BANGTAN BOMB] '호르몬전쟁' dance performance (Real WAR ver.)	70SMjxn4FBA
[CHOREOGRAPHY] BTS (방탄소년단) 'I NEED U' Dance Practice	hvUZb9NT7EY
BTS (방탄소년단) 가요대제전 Intro performance Trailer	S1Up-ZzHmuw
Private video	hoTBL39i60M
[CHOREOGRAPHY] BTS (방탄소년단) '호르몬전쟁' Dance practice	JumcC5jFcQc
[BANGTAN BOMB] 방탄도령단 - 危險 (Appeal ver.)	rvj2O-O6JGQ
[CHOREOGRAPHY] BTS (방탄소년단) 'Danger' dance practice	vJwHIpEogEY
[CHOREOGRAPHY] BTS (방탄소년단) 'Beautiful' dance practice	sm4FFFBgbmg
[CHOREOGRAPHY] BTS (방탄소년단) '어른아이' dance practice	qaOMutxg1OE
[BANGTAN BOMB] 'Just one day' practice (Appeal ver.)	zNJMa43UVs0
BTS (방탄소년단) '하루만(Just one day)' dance practice	2DFvc5o5xAY
[BANGTAN BOMB] when BTS was practicing the showcase	QKeXCmmpk28
방탄소년단 '상남자(Boy In Luv)' dance practice	gqz6Adx63w8
방탄소년단 팔도강산(Paldogangsan) Dance practice	Vi6-zq3YuEg
방탄소년단 -No More Dream- Dance Practice	EBzr2udonZI
방탄소년단 'N.O' dance practice	_VoSHt8zFNI
방탄소년단 Concept Trailer dance practice	m7QNUWXoO_s
Dance practice by 지민 of 방탄소년단	4wpn3y66mzY
정국이의 춤 연습	Bpcczy88UWg
Dance practice by 정국 of 방탄소년단	Q3lL7zQ7kkA
Dance practice by J-HOPE&지민&정국	E8Z0aWn9T0o
Dance practice by 지민 of 방탄소년단 - Bait	rF21f3JmudY
Vocal practice by 정국 of 방탄소년단	zclObyFrY-U
[CHOREOGRAPHY] BTS (방탄소년단) Dance break Practice	xJg_FvMe4hE
[CHOREOGRAPHY] BTS (방탄소년단) 'We Are Bulletproof Pt.2' dance practice	bV9Svms-LYY
[CHOREOGRAPHY] BTS (방탄소년단) '진격의 방탄 (Attack on BTS)' Dance Practice	ncRNKuwOEc0
방탄소년단 MBC 가요대제전 performance practice	wFTImbQbXdk
방탄소년단 SBS 가요대전 performance practice	j2rS6vXApF0
