[BANGTAN BOMB] 'Dynamite' Stage CAM (BTS focus) @ 2020 GMA - BTS (방탄소년단)	MlPydb5p_Pk
[BANGTAN BOMB] SUGA's "BE" Album Review - BTS (방탄소년단)	yIYzsnU9Dhk
[BANGTAN BOMB] 'Dynamite' Stage CAM (Jung Kook focus) @ 2020 AMAs - BTS (방탄소년단)	td9Zserex5Y
[BANGTAN BOMB] 'Dynamite' Stage CAM (Jin focus) @ 2020 AMAs - BTS (방탄소년단)	UoeLS6MPE2Q
[BANGTAN BOMB] 'Dynamite' Stage CAM (j-hope focus) @ 2020 AMAs - BTS (방탄소년단)	ytQPmNbLbz8
[BANGTAN BOMB] 'Dynamite' Stage CAM (Jimin focus) @ 2020 AMAs - BTS (방탄소년단)	Enyg6bafusc
[BANGTAN BOMB] 'Dynamite' Stage CAM (V focus) @ 2020 AMAs - BTS (방탄소년단)	rfeABhP0I5A
[BANGTAN BOMB] 'Dynamite' Stage CAM (SUGA focus) @ 2020 AMAs - BTS (방탄소년단)	1yXSdBICcPU
[BANGTAN BOMB] 'Dynamite' Stage CAM (RM focus) @ 2020 AMAs - BTS (방탄소년단)	k8OI8LEkShA
[BANGTAN BOMB] 'Dynamite' Stage CAM (BTS focus) @ 2020 AMAs - BTS (방탄소년단)	Vr_0ipbiALc
[BANGTAN BOMB] 'Life Goes On' Stage CAM (Jimin focus) @ 2020 AMAs - BTS (방탄소년단)	G9sZJkVoTUU
[BANGTAN BOMB] 'Life Goes On' Stage CAM (RM focus) @ 2020 AMAs - BTS (방탄소년단)	K8_mJT9KxnU
[BANGTAN BOMB] 'Life Goes On' Stage CAM (V focus) @ 2020 AMAs - BTS (방탄소년단)	f1cXJBWPuUU
[BANGTAN BOMB] 'Life Goes On' Stage CAM (SUGA focus) @ 2020 AMAs - BTS (방탄소년단)	5wOqLWi7Txw
[BANGTAN BOMB] 'Life Goes On' Stage CAM (Jung Kook focus) @ 2020 AMAs - BTS (방탄소년단)	wlUHopKAcv8
[BANGTAN BOMB] 'Life Goes On' Stage CAM (j-hope focus) @ 2020 AMAs - BTS (방탄소년단)	-emFNoWvH7g
[BANGTAN BOMB] 'Life Goes On' Stage CAM (Jin focus) @ 2020 AMAs - BTS (방탄소년단)	eb5UD5S7inw
[BANGTAN BOMB] 'Life Goes On' Stage CAM (BTS focus) @ 2020 AMAs - BTS (방탄소년단)	iK86ae14jV4
[BANGTAN BOMB] Jimin's Black Swan Solo Behind the Scenes - BTS (방탄소년단)	xMfp2jcK52M
[BANGTAN BOMB] Musical Actors BTS - BTS (방탄소년단)	lSK4Mvap5i0
[BANGTAN BOMB] Who's That Shadow? - BTS (방탄소년단)	wkMKOeMlCW4
[BANGTAN BOMB] 'Dynamite' Stage CAM (BTS focus) @ BBMAs 2020 - BTS (방탄소년단)	F43Rj9c1TQs
[BANGTAN BOMB] 'Dynamite' Stage CAM (BTS focus) @ Radio.com LIVE - BTS (방탄소년단)	xBlNwc3_kG0
[BANGTAN BOMB] BTS Donut Time - BTS (방탄소년단)	uBVk19XJsfs
[BANGTAN BOMB] On the Phone with Bang PD - BTS (방탄소년단)	8s71HwinvZU
[BANGTAN BOMB] 'Dynamite' Stage CAM (BTS focus) @ Gyeongbokgung - BTS (방탄소년단)	nF1zZIETE5k
[BANGTAN BOMB] Spelling with Water Bottles - BTS (방탄소년단)	56hzvu35wRU
[BANGTAN BOMB] BTS Basketball - BTS (방탄소년단)	byyZkQT7zZU
[BANGTAN BOMB] 'Dynamite' Stage CAM (BTS focus) @ NPR Tiny Desk Concert - BTS (방탄소년단)	qqN4UWnfcQA
[BANGTAN BOMB] 'Dynamite' Stage CAM (BTS focus) @ TODAY Citi Music Series - BTS (방탄소년단)	-Rn2lDcbQBc
[BANGTAN BOMB] 'Dynamite' Stage CAM (BTS focus) @ 2020 iHeartRadio Music Festival - BTS (방탄소년단)	Bc3OibcQNHA
[BANGTAN BOMB] V-ianist's Recital - BTS (방탄소년단)	h42mRQ_eqqI
[BANGTAN BOMB] 'Dynamite' MV (B-Side) Reaction - BTS (방탄소년단)	tqB9k3py_sU
[BANGTAN BOMB] 'Dynamite' Stage CAM (BTS focus) @ 2020 MTV VMAs - BTS (방탄소년단)	2DKJO8YBWas
[BANGTAN BOMB] 'Dynamite' MV Reaction - BTS (방탄소년단)	82wGTOAdt2A
[BANGTAN BOMB] JiJinJung Ice Cream Swirl - BTS (방탄소년단)	aINyQp70wLg
[BANGTAN BOMB] 'MAP OF THE SONG : 7' Behind the Scenes - BTS (방탄소년단)	qt8hoQyF4uo
[BANGTAN BOMB] I Prayed That I Could Get to My Part - BTS (방탄소년단)	eg65NNW8Xd4
[BANGTAN BOMB] There's a Dog on the Set with BTS! - BTS (방탄소년단)	r47JB0qO8yk
[BANGTAN BOMB] Cute and Adorable BTS - BTS (방탄소년단)	IG2K4Vl4QOg
[BANGTAN BOMB] BTS' Caretaker Jin - BTS (방탄소년단)	Da2S-qLd8u0
[BANGTAN BOMB] 슙디의 꿀 FM 06.13 #0613FM_0613 with BTS Highlight Clip - BTS (방탄소년단)	7_e6j_mPQio
[BANGTAN BOMB] How to Stay Warm on the Set - BTS (방탄소년단)	jS8WPZuiRao
[BANGTAN BOMB] Jimin's Short and Sweet Impersonation - BTS (방탄소년단)	5Ogih1Lsgxc
[BANGTAN BOMB] The No No Game - BTS (방탄소년단)	pQbZdshxQnE
[BANGTAN BOMB] Stretching Class - BTS (방탄소년단)	VMYz3O3iFMU
[BANGTAN BOMB] BTS Does Impressions - BTS (방탄소년단)	7zRVhwXI3m8
[BANGTAN BOMB] Today's Song Is About A Special Guest? - BTS (방탄소년단)	2eyWU6Y3Ae8
[BANGTAN BOMB] Jung Kook's Art Class - BTS (방탄소년단)	zbSYc62O-pg
[BANGTAN BOMB] '보.라.해' VCR time behind - BTS (방탄소년단)	VKgwy4rWjhA
[BANGTAN BOMB] '보.라.해' VCR time behind - BTS (방탄소년단)	VKgwy4rWjhA
[BANGTAN BOMB] A Boisterous Shooting of '3J' - BTS (방탄소년단)	lMmd4Fc6HFA
[BANGTAN BOMB] A Boisterous Shooting of '3J' - BTS (방탄소년단)	lMmd4Fc6HFA
[BANGTAN BOMB] Whatcha watchin', JK? - BTS (방탄소년단)	QCW-_Xt2dBY
[BANGTAN BOMB] Behind The Scenes Of 2019 MMA Performance Practice  - BTS (방탄소년단)	GbUlWapHAuI
[BANGTAN BOMB] Behind The Scenes Of 2019 MMA Performance Practice  - BTS (방탄소년단)	GbUlWapHAuI
[BANGTAN BOMB] Photographer Jin! - BTS (방탄소년단)	xghOsv7eLYQ
[BANGTAN BOMB] Mischievous Boys - BTS (방탄소년단)	1vQPMR1qlHI
[BANGTAN BOMB] Mischievous Boys - BTS (방탄소년단)	1vQPMR1qlHI
[BANGTAN BOMB] Who's This Unexpected Guest? - BTS (방탄소년단)	Na5FurIcjEg
[BANGTAN BOMB] Let's play hopscotch  - BTS (방탄소년단)	8eX7p7AzXkI
[BANGTAN BOMB] Tonight Show Subway - BTS (방탄소년단)	bztpz8Hg6C4
[BANGTAN BOMB] Tonight Show Subway - BTS (방탄소년단)	bztpz8Hg6C4
[BANGTAN BOMB] BTS STAGE SELF-CAM '등골브레이커' @ 190615 MAGIC SHOP - BTS (방탄소년단)	rqG8CF1eKlY
[BANGTAN BOMB] BTS STAGE SELF-CAM '등골브레이커' @ 190615 MAGIC SHOP - BTS (방탄소년단)	rqG8CF1eKlY
[BANGTAN BOMB] Boxing with a Squeaky Hammer - BTS (방탄소년단)	dOo_qGp-Uvk
[BANGTAN BOMB] BTS at the CONNECT, BTS exhibition in New York - BTS (방탄소년단)	fXXl_ENR4Ak
[BANGTAN BOMB] BTS ‘Black Swan’ MV reaction - BTS (방탄소년단)	LQK7tF1vH2w
[BANGTAN BOMB] 3J Unit Photo Shooting behind - BTS (방탄소년단)	SnGWLnVWc74
[BANGTAN BOMB] 3J Unit Photo Shooting behind - BTS (방탄소년단)	SnGWLnVWc74
[BANGTAN BOMB] 'ON' Stage CAM (BTS focus) @ 200308 Inkigayo - BTS (방탄소년단)	2bruuX5BB38
[BANGTAN BOMB] 'Black Swan' Stage CAM (BTS focus) @ 200301 Inkigayo - BTS (방탄소년단)	HYx1bPcEEyg
[BANGTAN BOMB] BTS amazed and amused by Galaxy Wall  - BTS (방탄소년단)	C0GpemShHZs
[BANGTAN BOMB] BTS ‘ON’ MV reaction - BTS (방탄소년단)	Q2metvIQavo
[BANGTAN BOMB] 'ON' Stage CAM (BTS focus) @ 200305 M COUNTDOWN - BTS (방탄소년단)	vMO4vPFOInQ
[BANGTAN BOMB] BTS at CONNECT, BTS in Seoul - BTS (방탄소년단)	0lAaH5q7GfA
[BANGTAN BOMB] Jin's selfie time - BTS (방탄소년단)	WS2HHargZ8Q
[BANGTAN BOMB] BTS reacts to BTS debut+5 Days  - BTS (방탄소년단)	ZkVuGYRCS7s
[BANGTAN BOMB] Preparing for CONNECT, BTS - BTS (방탄소년단)	FFDxZtdxZzE
[BANGTAN BOMB] 'ON' Stage CAM (BTS focus) @200227 M COUNTDOWN - BTS (방탄소년단)	vmp7TIMDExo
[BANGTAN BOMB] 'ON' Stage CAM (BTS focus) @200227 M COUNTDOWN - BTS (방탄소년단)	vmp7TIMDExo
[BANGTAN BOMB] 'Black Swan' Stage CAM (BTS focus) @200227 M COUNTDOWN - BTS (방탄소년단)	rYFhecCagjU
[BANGTAN BOMB] 'Black Swan' Stage CAM (BTS focus) @200227 M COUNTDOWN - BTS (방탄소년단)	rYFhecCagjU
[BANGTAN BOMB] 'ON' Kinetic Manifesto Film (BTS focus) - BTS (방탄소년단)	8F7eRV2N_ik
[BANGTAN BOMB] Workout Boys - BTS (방탄소년단)	fD_ELtkl50Y
[BANGTAN BOMB] BTS' Mukbang! - BTS (방탄소년단)	v-d_HYStn5U
[BANGTAN BOMB] BTS meets Pengsoo! @ 2020 GDA - BTS (방탄소년단)	C9-HKRPCrw8
[BANGTAN BOMB] Let's warm up! - BTS (방탄소년단)	8uw5zaSiYLs
[BANGTAN BOMB] Let's warm up! - BTS (방탄소년단)	8uw5zaSiYLs
[BANGTAN BOMB] BTS 'Black Swan' Art Film Reaction - BTS (방탄소년단)	zR9q5iU-gJU
[BANGTAN BOMB] BTS 'Black Swan' Art Film Reaction - BTS (방탄소년단)	zR9q5iU-gJU
[BANGTAN BOMB] Jin & V Sing Together! - BTS (방탄소년단)	VK5xjAJ3PJE
[BANGTAN BOMB] V’s Surprise Birthday Party - BTS (방탄소년단)	FlRKvErmOHc
[BANGTAN BOMB] V’s Surprise Birthday Party - BTS (방탄소년단)	FlRKvErmOHc
[BANGTAN BOMB] How much ice cream did Jung Kook eat? - BTS (방탄소년단)	x-TvlvX5rGM
[BANGTAN BOMB] '보조개' Special Stage (Vocal line focus) @ 2020 GDA - BTS (방탄소년단)	0V8tnMeiaig
[BANGTAN BOMB] 'Skool Luv Affair' Special Stage (Rap line focus) @ 2020 GDA - BTS (방탄소년단)	2CI3XE8Wjpg
[BANGTAN BOMB] 'Skool Luv Affair' Special Stage (Rap line focus) @ 2020 GDA - BTS (방탄소년단)	2CI3XE8Wjpg
[BANGTAN BOMB] Jin’s birthday party behind the scenes - BTS (방탄소년단)	4DxC1U3SYkc
[BANGTAN BOMB] '작은 것들을 위한 시 (Boy With Luv)' Special Stage (BTS focus) @ NYRE 2020 - BTS (방탄소년단)	UbibhcTvNlU
[BANGTAN BOMB] '작은 것들을 위한 시 (Boy With Luv)' Special Stage (BTS focus) @ NYRE 2020 - BTS (방탄소년단)	UbibhcTvNlU
[BANGTAN BOMB] Happy New Year 2020! - BTS (방탄소년단)	zDP_EQYmT6U
[BANGTAN BOMB] 'Let Go' Stage Cam (BTS focus) @ 191215 MAGIC SHOP - BTS (방탄소년단)	VOS766qqzlM
[BANGTAN BOMB] 'Let Go' Stage Cam (BTS focus) @ 191215 MAGIC SHOP - BTS (방탄소년단)	VOS766qqzlM
[BANGTAN BOMB] How it all began: 'BTS TIME' - BTS (방탄소년단)	ayjMZW-f7-A
[BANGTAN BOMB] How it all began: 'BTS TIME' - BTS (방탄소년단)	ayjMZW-f7-A
[BANGTAN BOMB] 'Skool Luv Affair' stage practice behind the scenes - BTS (방탄소년단)	K4paFn9dwfI
[BANGTAN BOMB] 'Skool Luv Affair' stage practice behind the scenes - BTS (방탄소년단)	K4paFn9dwfI
[BANGTAN BOMB] Where is BTS going? (Hint: RM’s comeback trailer) – BTS (방탄소년단)	k6mx-k_DVo8
[BANGTAN BOMB] Jimin's calligraphy skills - BTS (방탄소년단)	SkHDzA_7YfA
[BANGTAN BOMB] 'MIC Drop' Special Stage (BTS focus) @ iHR Jingle Ball - BTS (방탄소년단)	HrPB-_tTgqM
[BANGTAN BOMB] 'MIC Drop' Special Stage (BTS focus) @ iHR Jingle Ball - BTS (방탄소년단)	HrPB-_tTgqM
[BANGTAN BOMB] '작은 것들을 위한 시 (Boy With Luv) feat. Halsey’ Special Stage @iHR Jingle Ball - BTS(방탄소년단)	qCwdJFwztl8
[BANGTAN BOMB] '작은 것들을 위한 시 (Boy With Luv) feat. Halsey’ Special Stage @iHR Jingle Ball - BTS(방탄소년단)	qCwdJFwztl8
[BANGTAN BOMB] BTS Snack Time! - BTS (방탄소년단)	CfWlBmpN4sM
[BANGTAN BOMB] RM, Jin & V having fun singing songs - BTS (방탄소년단)	Jpv24FPqr2g
[BANGTAN BOMB] Members' opinions on each other's solo performance @181227 KBS 가요대축제 - BTS (방탄소년단)	8ieEcDwdT5E
[BANGTAN BOMB] ‘작은 것들을 위한 시(Boy With Luv)’+'소우주(Mikrokosmos)' Special Stage (BTS focus) @ 2019 MAMA	5rr86SveC0U
[BANGTAN BOMB] ‘작은 것들을 위한 시(Boy With Luv)’+'소우주(Mikrokosmos)' Special Stage (BTS focus) @ 2019 MAMA	5rr86SveC0U
[BANGTAN BOMB] 'Dionysus' Special Stage (BTS focus) @ 2019 MAMA - BTS (방탄소년단)	PS-zH-V_too
[BANGTAN BOMB] 'Dionysus' Special Stage (BTS focus) @ 2019 MAMA - BTS (방탄소년단)	PS-zH-V_too
[BANGTAN BOMB] ‘We Are Bulletproof PT.2’ Special Stage (BTS focus) @ 2019 MAMA - BTS (방탄소년단)	5s3y_JLYu-Q
[BANGTAN BOMB] ‘We Are Bulletproof PT.2’ Special Stage (BTS focus) @ 2019 MAMA - BTS (방탄소년단)	5s3y_JLYu-Q
[BANGTAN BOMB] ‘N.O’ Special Stage (BTS focus) @ 2019 MAMA - BTS (방탄소년단)	cF-3jdST_vY
[BANGTAN BOMB] 'Dionysus' Intro Performance (On-Air ver.) @ 2019 MMA - BTS (방탄소년단)	VA_K4zmY7Jw
[BANGTAN BOMB] 'Dionysus' Intro Performance (On-Air ver.) @ 2019 MMA - BTS (방탄소년단)	VA_K4zmY7Jw
[BANGTAN BOMB] 'Dionysus' Intro Performance (BTS focus) @ 2019 MMA - BTS (방탄소년단)	yuCeFXsxBYQ
[BANGTAN BOMB] '작은 것들을 위한 시 (Boy With Luv)' Special Stage (BTS focus) @ 2019 MMA - BTS (방탄소년단)	AiI7eL778g0
[BANGTAN BOMB] '작은 것들을 위한 시 (Boy With Luv)' Special Stage (BTS focus) @ 2019 MMA - BTS (방탄소년단)	AiI7eL778g0
[BANGTAN BOMB] '상남자 (Boy In Luv)' Special Stage (BTS focus) @ 2019 MMA - BTS (방탄소년단)	_N1_OpmBdEo
[BANGTAN BOMB] '상남자 (Boy In Luv)' Special Stage (BTS focus) @ 2019 MMA - BTS (방탄소년단)	_N1_OpmBdEo
[BANGTAN BOMB] 'Dionysus' Special Stage (BTS focus) @ 2019 MMA - BTS (방탄소년단)	lQswxVHDo8U
[BANGTAN BOMB] '소우주 (Mikrokosmos)' Special Stage (BTS focus) @ 2019 MMA - BTS (방탄소년단)	FVOFycytFDE
[BANGTAN BOMB] Behind the scenes, recording Euphoria (DJ Swivel Forever Mix ver.) - BTS (방탄소년단)	uebcd3HoNOs
[BANGTAN BOMB] Jin, Recording his first ever composition - BTS (방탄소년단)	LFvSldkKpK8
[BANGTAN BOMB] Let's do squats together - BTS (방탄소년단)	vGjBHqdFGj8
[BANGTAN BOMB] What SUGA did in his free time - BTS (방탄소년단)	ui_UV_HK790
[BANGTAN BOMB] Everyone loves bread~!  - BTS (방탄소년단)	kUlWhxm0Y0M
[BANGTAN BOMB] Arm wrestling! WHO IS THE WINNER?! - BTS (방탄소년단)	RoepaDKQ0PQ
[BANGTAN BOMB] BTS’ birthday surprise for Jimin @ Saudi Arabia - BTS (방탄소년단)	nxtxJBmMp7c
[BANGTAN BOMB] Guess whose handwriting! @ BTS POP-UP : HOUSE OF BTS - BTS (방탄소년단)	g9q1mAyN6eM
[BANGTAN BOMB] Guess whose handwriting! @ BTS POP-UP : HOUSE OF BTS - BTS (방탄소년단)	g9q1mAyN6eM
[BANGTAN BOMB] V dances ‘MIC Drop’ @ BTS POP-UP : HOUSE OF BTS - BTS (방탄소년단)	6q9GuvoZueE
[BANGTAN BOMB] What's the meaning of '방.무.행.알' @ BTS POP-UP : HOUSE OF BTS - BTS (방탄소년단)	7EXs0VHpcRA
[BANGTAN BOMB] Play the Piano @ BTS POP-UP : HOUSE OF BTS - BTS (방탄소년단)	rYK5dpjehyM
[BANGTAN BOMB] Dance With BTS @ BTS POP-UP : HOUSE OF BTS - BTS (방탄소년단)	JMhtwxe2f0A
[BANGTAN BOMB] Dance With BTS @ BTS POP-UP : HOUSE OF BTS - BTS (방탄소년단)	JMhtwxe2f0A
[BANGTAN BOMB] Jimin is directing a new music video?! - BTS (방탄소년단)	qwLDjWbHWEc
[BANGTAN BOMB] Snack time! @181225 SBS 가요대전 - BTS (방탄소년단)	gRcNqc4TD84
[BANGTAN BOMB] What happened during the V LIVE - BTS (방탄소년단)	oC1p2CVHQWE
[BANGTAN BOMB] Rockin' out with invisible instruments - BTS (방탄소년단)	H2RB5m4OdFc
[BANGTAN BOMB] Jacket shooting in the bathroom - BTS (방탄소년단)	arRwuQyFpgI
[BANGTAN BOMB] V's flower arrangement class - BTS (방탄소년단)	zSmteBt4HwY
[BANGTAN BOMB] Hot Dog Master JK - BTS (방탄소년단)	YzE8vFSQ5XQ
[BANGTAN BOMB] Rainy day in New York - BTS (방탄소년단)	Lh_VezZyZkc
[BANGTAN BOMB] Let's play guitar! - BTS (방탄소년단)	qfRTd4XmXz4
[BANGTAN BOMB] Jimin plays with a balloon - BTS (방탄소년단)	39ylpRfs--8
[BANGTAN BOMB] Let's make a song - BTS (방탄소년단)	MseM0rOF2YA
[BANGTAN BOMB] Last day of 'Boy With Luv' stage @ 2019 슈퍼콘서트 - BTS (방탄소년단)	uf4g42-WsCE
[BANGTAN BOMB] The endless singing in harmony - BTS (방탄소년단)	imxhxP0L-RA
[BANGTAN BOMB] j-hope & JK's Free Dance! - BTS (방탄소년단)	rDWBvMwuu-s
[BANGTAN BOMB] Making stickers for ARMY - BTS (방탄소년단)	4ZeUVuUvnmo
[BANGTAN BOMB] j-hope & V reaction to TXT Cat & Dog - BTS (방탄소년단)	io0ZLZ8kMZk
[BANGTAN BOMB] BTS won the 1st & Piggyback @190425 M COUNTDOWN - BTS (방탄소년단)	yDmXJ9Au1QQ
[BANGTAN BOMB] Drummer Boy V & JK - BTS (방탄소년단)	TBRw27OmsvQ
[BANGTAN BOMB] j-hope & Jimin Let's exercise - BTS (방탄소년단)	EzX-CD4kzV4
[BANGTAN BOMB] BTS to form a band - BTS (방탄소년단)	XF9jM4bM8aY
[BANGTAN BOMB] BTS English class - BTS (방탄소년단)	yQkuvbLwy38
[BANGTAN BOMB] BTS English class - BTS (방탄소년단)	yQkuvbLwy38
[BANGTAN BOMB] 'Winter Bear' cover shooting behind - BTS (방탄소년단)	oU_OmKOZtMs
[BANGTAN BOMB] 'Winter Bear' cover shooting behind - BTS (방탄소년단)	oU_OmKOZtMs
[BANGTAN BOMB] Behind the stage of ‘Boy With Luv’ (Heart ver.) - BTS (방탄소년단)	y1H64IvfP6I
[BANGTAN BOMB] JK taking a photo of members sleeping - BTS (방탄소년단)	AmA8Y3el7WY
[BANGTAN BOMB] 'MIC Drop' Stage CAM (BTS focus) @2019 Lotte Family Concert - BTS (방탄소년단)	vUNMxnvWXuo
[BANGTAN BOMB] 'Best Of Me' Stage CAM (BTS focus) @2019 Lotte Family Concert - BTS (방탄소년단)	r_TRMLJeppY
[BANGTAN BOMB] 'IDOL' Stage CAM (BTS focus) @2019 Lotte Family Concert - BTS (방탄소년단)	9gGsZI1Nzz4
[BANGTAN BOMB] 'HOME' Stage CAM (BTS focus) @2019 Lotte Family Concert - BTS (방탄소년단)	f_u_JjZEJII
[BANGTAN BOMB] '작은 것들을 위한 시 (Boy With Luv)' Stage CAM (BTS focus) @2019 Lotte Family Concert	tQCXhTDGXOs
[BANGTAN BOMB] '풍경' Special LIVE - BTS (방탄소년단)	4lKqFR-67RI
[BANGTAN BOMB] BTS' Food Talk! - BTS (방탄소년단)	7Tm0cL96MNU
[BANGTAN BOMB] RM’s Surprise(?) Birthday Party - BTS (방탄소년단)	wksUmcAx7z4
[BANGTAN BOMB] RM reading a book - BTS (방탄소년단)	mw-JgIonmD8
[BANGTAN BOMB] Last day of 'Dionysus' stage @ Ingigayo - BTS (방탄소년단)	lkXecd3qCZk
[BANGTAN BOMB] JK & V experienced a new job! - BTS (방탄소년단)	fgja5tdRB8o
[BANGTAN BOMB] Jimin's Self Camera - BTS (방탄소년단)	HH8QwJ7eBTU
[BANGTAN BOMB] V's idea of loving art - BTS (방탄소년단)	G1F10lMOj40
[BANGTAN BOMB] Do you know Maginot Line? - BTS (방탄소년단)	GWuXehXC_l8
[BANGTAN BOMB] Let's Pizza Party! - BTS (방탄소년단)	gqvEO6o1Mx8
[BANGTAN BOMB] JK's Heart (for ARMY♥︎) - BTS (방탄소년단)	N76HNPfI4zs
[BANGTAN BOMB] Practice 'Thyrsos' Performance - BTS (방탄소년단)	cyYpQXWpgc0
[BANGTAN BOMB] Jin's Sunglasses Collection in Hong Kong - BTS (방탄소년단)	aeECAHu98KU
[BANGTAN BOMB] Dance Battle during ‘IDOL’ MV shoot - BTS (방탄소년단)	FMtnvtqwuis
[BANGTAN BOMB] Exciting Reaction Shooting - BTS (방탄소년단)	EX2KGU-kXoQ
[BANGTAN BOMB] '방탄도령단' Theater of situations - BTS (방탄소년단)	rT4ahaGetmg
[BANGTAN BOMB] Who made a surprise visit?! - BTS (방탄소년단)	nQoWRzoFU5M
[BANGTAN BOMB] The secret of BTS' beard  - BTS (방탄소년단)	FsEGaURjZ8w
[BANGTAN BOMB] Playing with Glasses - BTS (방탄소년단)	UFRMRTUcaB8
[BANGTAN BOMB] Last day of ‘IDOL’ stage @ Ingigayo - BTS (방탄소년단)	cRkkRYcqqOg
[BANGTAN BOMB] The day when ‘김연탄(KimYeonTan)’ came to the broadcasting station - BTS (방탄소년단)	o6scfYIPq5U
[BANGTAN BOMB] Chicken Party~! - BTS (방탄소년단)	i2AjAqKpOug
[BANGTAN BOMB] 'IDOL' Stage CAM @2019 슈퍼콘서트 - BTS (방탄소년단)	uNSlfn66HB8
[BANGTAN BOMB] 'Make It Right' Stage CAM @2019 슈퍼콘서트 - BTS (방탄소년단)	XEJwXh1423M
[BANGTAN BOMB] 'DNA' Stage CAM @2019 슈퍼콘서트 - BTS (방탄소년단)	RvUw3P5r2m0
[BANGTAN BOMB] '작은 것들을 위한 시 (Boy With Luv)' Stage CAM @ BBMAs 2019 - BTS (방탄소년단)	W0u1R2H1iHQ
[BANGTAN BOMB] Challenge to post 'TO.BTS' - BTS (방탄소년단)	hJyC8y_0tTs
[BANGTAN BOMB] '작은 것들을 위한 시 (Boy With Luv)' Dance Practice (Eye contact ver.) - BTS (방탄소년단)	o03lR8ErvL0
[BANGTAN BOMB] 'MAP OF THE SOUL : PERSONA' Album Unboxing (BTS ver.) - BTS (방탄소년단)	edGx9VoIWoI
[BANGTAN BOMB] Challenge a Pre-Recording~! - BTS (방탄소년단)	lYPyckHBzVg
[BANGTAN BOMB] 'Dionysus' Stage CAM (BTS focus) @190421 Ingigayo - BTS (방탄소년단)	vAS8D2sqVuo
[BANGTAN BOMB] 'Dionysus' Stage CAM (BTS focus) @190420 Show Music Core - BTS (방탄소년단)	mod-9ln_bmE
[BANGTAN BOMB] 'Dionysus' Stage CAM (BTS focus) @190418 M COUNTDOWN - BTS (방탄소년단)	zMx-En_wLDA
[BANGTAN BOMB] '작은 것들을 위한 시 (Boy With Luv)' Stage CAM (BTS focus) @190418 M COUNTDOWN - BTS (방탄소년단)	8clfdAILyJA
[BANGTAN BOMB] SUGA’s Surprise Birthday Party! - BTS (방탄소년단)	dIxMMA-w0p4
[BANGTAN BOMB] Drawing from 'IDOL' MV - BTS (방탄소년단)	aGHzgGIWjvQ
[BANGTAN BOMB] Come again! JK & Jin's exercise time! - BTS (방탄소년단)	g3leOclIiEM
[BANGTAN BOMB] Memory squirrel Jimin showing off acorn - BTS (방탄소년단)	jsxEeNh58Pg
[BANGTAN BOMB] V's Piano solo showcase - BTS (방탄소년단)	8E1iXifT1e8
[BANGTAN BOMB] Monitoring MMA (with. 쩝) - BTS (방탄소년단)	2eYKozJ257w
[BANGTAN BOMB] Playing with Film Camera - BTS (방탄소년단)	u1K7bIHM7KM
[BANGTAN BOMB] Jimin poses like mannequin! - BTS (방탄소년단)	d_Xt_aysQ7w
[BANGTAN BOMB] Worldwide Handsome's Chicken! - BTS (방탄소년단)	ptz3zOVILNg
[BANGTAN BOMB] Hobi’s Surprise Birthday Party! - BTS (방탄소년단)	qsP1NdhcGhw
[BANGTAN BOMB] SUGA's '신청곡 (Song Request)' recording behind - BTS (방탄소년단)	kGe7EMMMyQ0
[BANGTAN BOMB] Curious boy JK - BTS (방탄소년단)	ziyVcEWEYlE
[BANGTAN BOMB] Standing in front of the window - BTS (방탄소년단)	Zw0Kd-EhkwE
[BANGTAN BOMB] V’s Surprise(?) Birthday Party - BTS (방탄소년단)	pjRHPgzb1Rg
[BANGTAN BOMB] Broken English Time! - BTS (방탄소년단)	HTVDBqifzQs
[BANGTAN BOMB] Sunglasses Jin's Surprise Birthday Party - BTS (방탄소년단)	dJGvcUHZeK0
[BANGTAN BOMB] 'FAKE LOVE' Special Stage (BTS focus) @2019 서울가요대상 - BTS (방탄소년단)	QkzTpW6z6Kg
[BANGTAN BOMB] 'IDOL' Special Stage (BTS focus) @2019 서울가요대상 - BTS (방탄소년단)	3QeSV-U4hWc
[BANGTAN BOMB] Concentrating on drawing JK - BTS (방탄소년단)	0JFgGQmiL4w
[BANGTAN BOMB] Enjoy the BTS EXHIBITION '24/7=Serendipity' - BTS (방탄소년단)	iSc1pr_RH6o
[BANGTAN BOMB] Jimin’s Surprise Birthday Party @Amsterdam - BTS (방탄소년단)	QuOM_3X5KS4
[BANGTAN BOMB] 'FAKE LOVE' Special Stage (BTS focus) @2019 GDA - BTS (방탄소년단)	emwlgC0te1U
[BANGTAN BOMB] 'Title Medley' Special Stage (BTS focus) @2018 가요대전 - BTS (방탄소년단)	LjqvwHrhhjo
[BANGTAN BOMB] 'IDOL' Special Stage (BTS focus) @2018 가요대전 - BTS (방탄소년단)	vV2lPiAyb7Q
[BANGTAN BOMB] Happy New Year 2019! - BTS (방탄소년단)	YMqOyMy7r_o
[BANGTAN BOMB] Surprise camera! Please come out early - BTS (방탄소년단)	3x1PR4xuG_Y
[BANGTAN BOMB] BTS PROM PARTY : UNIT STAGE BEHIND - Jimin & Jung Kook - BTS (방탄소년단)	JbjvlCFVAxA
[BANGTAN BOMB] Special lyrics of Anpanman - BTS (방탄소년단)	tDEg_urfgAw
[BANGTAN BOMB] 'FAKE LOVE' Special Stage (BTS focus) @2018 MAMA - BTS (방탄소년단)	KpJJMtK1C1c
[BANGTAN BOMB] 'IDOL' 1st Win Behind - BTS (방탄소년단)	KJY6IJnSWPw
[BANGTAN BOMB] 'Airplane pt.2' Special Stage (BTS focus) @2018 MMA - BTS (방탄소년단)	iwZDQm7f8Tg
[BANGTAN BOMB] 'FAKE LOVE' Special Stage (BTS focus) @2018 MMA - BTS (방탄소년단)	e4LSXCZOupE
[BANGTAN BOMB] Jin & j-hope Play with Earrings - BTS (방탄소년단)	fqWKzndgvHY
[BANGTAN BOMB] 'IDOL' Intro Performance (3J focus) @2018 MMA - BTS (방탄소년단)	w2hn8OJbJSo
[BANGTAN BOMB] 'IDOL' Special Stage (BTS focus) @2018 MMA - BTS (방탄소년단)	ayGl-igrwy8
[BANGTAN BOMB] JK is trying new filming stuff - BTS (방탄소년단)	yBF3C6OyzX8
[BANGTAN BOMB] 'IDOL' Special Stage (BTS focus) @2018 AAA - BTS (방탄소년단)	Gjebo7ubcuU
[BANGTAN BOMB] 'FAKE LOVE' Special Stage (BTS focus) @2018 AAA - BTS (방탄소년단)	G6vWKceFSs0
[BANGTAN BOMB] Last day of 'FAKE LOVE' stage @ Ingigayo - BTS (방탄소년단)	HP_qouNbTEg
[BANGTAN BOMB] BTS won the 1st & Special MC Jin @MUSICBANK - BTS (방탄소년단)	MdUeyb5gvsY
[BANGTAN BOMB] SUGA is eating snack - BTS (방탄소년단)	ofpoLjGKVlo
[BANGTAN BOMB] '아미밤(ARMY BOMB)' acrostic poem! - BTS (방탄소년단)	lErzvCpaArc
[BANGTAN BOMB] Excuses about destroyed JK's Shirt - BTS (방탄소년단)	BNhpqhhTqHs
[BANGTAN BOMB] Today JIMIN has not done 'JIMIN' - BTS (방탄소년단)	_cKBj-X_eHY
[BANGTAN BOMB] JK’s Surprise Birthday Party - BTS (방탄소년단)	2-524tCXqhw
[BANGTAN BOMB] Jimin is eating snack - BTS (방탄소년단)	6ZrkeDBurg8
[BANGTAN BOMB] JK & JIN's exercise time - BTS (방탄소년단)	SB_O8oo6wXY
[BANGTAN BOMB] JJIN time - BTS (방탄소년단)	c6vNtSYyEz4
[BANGTAN BOMB] JK's self hair styling - BTS (방탄소년단)	V6aDO2HAtus
[BANGTAN BOMB] Behind story at morning of MUSIC BANK day (180831) - BTS (방탄소년단)	kH6iFC1XIj0
[BANGTAN BOMB] JIN's 'Epiphany' practice - BTS (방탄소년단)	9pBfyHHefaE
[BANGTAN BOMB] BTS 'IDOL' MV reaction - BTS (방탄소년단)	5Lyg0RwRZto
[BANGTAN BOMB] 'IDOL' Special Stage (BTS focus) @​2018 SOBA Awards - BTS (방탄소년단)	eqPMQc7Mq4Q
​[BANGTAN BOMB] ​'​IDOL' Comeback Stage (BTS focus) @​MCOUNTDOWN - BTS (방탄소년단)	pi6N8vAg19A
[BANGTAN BOMB] ​'​Save ME + I'm Fine' Comeback Stage (BTS focus) @​MCOUNTDOWN - BTS (방탄소년단)	i2nRmxIQxSo
[BANGTAN BOMB] Naughty Boy Hobi - BTS (방탄소년단)	iqMkfDshyJY
[BANGTAN BOMB] Photographer JIN - BTS (방탄소년단)	L6-wjKRayzM
[BANGTAN BOMB] Sleeping beauty V! - BTS (방탄소년단)	4ikc-EBc8Ik
​[BANGTAN BOMB] ​'​FAKE LOVE' Special Stage (BTS focus) @​​BTS COMEBACK SHOW - BTS (방탄소년단)	B8T0VmrX4g0
[BANGTAN BOMB] Taking a photo carefully by JK - BTS (방탄소년단)	tTTdsJg2ujw
​[BANGTAN BOMB] ​'Best Of Me' Special Stage (BTS focus) @​BTS COMEBACK SHOW - BTS (방탄소년단)	2Mppta4RgDs
[BANGTAN BOMB] Jin & j-hope Massage Time?! - BTS (방탄소년단)	FkThHc465KA
[BANGTAN BOMB] Get Baby JK's attention - BTS (방탄소년단)	o13GlAybPPo
[BANGTAN BOMB] Who gets up at the end? - BTS (방탄소년단)	U0pqlLyLWKc
​[BANGTAN BOMB] ​'​Fire' Special Stage (BTS focus) @​BTS COMEBACK SHOW - BTS (방탄소년단)	lYC67_STvLI
[BANGTAN BOMB] Camera Director Jung kook & V - BTS (방탄소년단)	Kql0DXBlGrE
[BANGTAN BOMB] BTS PROM PARTY : UNIT STAGE BEHIND - 죽어도 너야 - BTS (방탄소년단)	X89bYonOqaA
​[BANGTAN BOMB] ​'​Anpanman' Special Stage (BTS focus) @​BTS COMEBACK SHOW - BTS (방탄소년단)	Js-iYNkddcA
[BANGTAN BOMB] Hobi's self camera @BTS COMEBACK SHOW - BTS (방탄소년단)	vDG9afx0Foc
[BANGTAN BOMB] BTS PROM PARTY : UNIT STAGE BEHIND - 땡 - BTS (방탄소년단)	h2nKAqf6bvY
​[BANGTAN BOMB] Jimin sings 'Serendipity' @BTS COUNTDOWN - BTS (방탄소년단) ​	tIGd1-ckvkc
​[BANGTAN BOMB] ​'​Tomorrow' Special Stage (BTS focus) @​BTS COUNTDOWN - BTS (방탄소년단)	dih52x7wqVU
​[BANGTAN BOMB] ​BTS on standby time @BTS COUNTDOWN - BTS (방탄소년단)	cbjZf5AWS8k
[BANGTAN BOMB] Behind the stage of ‘Dope’ @BTS COUNTDOWN - BTS (방탄소년단)	beVucFK62hY
[BANGTAN BOMB] BTS PROM PARTY : UNIT STAGE - 땡 - BTS (방탄소년단)	JuZwvYDQ92E
[BANGTAN BOMB] BTS PROM PARTY : UNIT STAGE - 죽어도 너야 - BTS (방탄소년단)	tt9nIyzN79Y
Private video	nNHy6xUDqwU
[BANGTAN BOMB] ‘FAKE LOVE’ Live Performance @2018 BBMAs - BTS (방탄소년단)	60Ks0ybPuac
[BANGTAN BOMB] BTS won 1st place (subtitle. Special MC day) @Mcountdown - BTS (방탄소년단)	Jn7rmGswb28
[BANGTAN BOMB] (toy) MIC Drop by J-HOPE - BTS (방탄소년단)	i35Oe5fXePs
[BANGTAN BOMB] BTS '고민보다 GO' stage with ARMY~perfect voice~ - BTS (방탄소년단)	b3jSr0d2Hw0
[BANGTAN BOMB] VJ Hobi's self camera @Musicbank - BTS (방탄소년단)	mHP3XqKHSsY
[BANGTAN BOMB] BTS standby time @ Mcountdown for DNA & MIC Drop comeback stage - BTS (방탄소년단)	TLgAdVv9sno
[BANGTAN BOMB] JIMIN's Piano solo showcase - BTS (방탄소년단)	Rgzr8LmFHN8
[BANGTAN BOMB] The cutest boy in the world is Hawaii-kkojili (suntanned JK in Hawaii) for BTS @VLIVE	7PQbMLc_sSs
[BANGTAN BOMB] j-hope & Jimin Dancing in Highlight Reel (Focus ver.) - BTS (방탄소년단)	Zq89pRZqhk0
[BANGTAN BOMB] BTS' exciting Game room #4 - BTS (방탄소년단)	fcjr0LGB_KE
[BANGTAN BOMB] BTS' exciting Game room #3 - BTS (방탄소년단)	HDPRzJ97Zos
[BANGTAN BOMB] BTS' exciting Game room #2 - BTS (방탄소년단)	xQXuZlD0h_c
[BANGTAN BOMB] BTS' exciting Game room #1 - BTS (방탄소년단)	ykZi4U9669A
[BANGTAN BOMB] 'MIC Drop' Special Stage (BTS focus) @2017 MBC 가요대제전 - BTS (방탄소년단)	po5QloRlOsM
[BANGTAN BOMB] '고민보다 Go' Special Stage (BTS focus) @2017 MBC 가요대제전 - BTS (방탄소년단)	T-iAqeqwGKU
[BANGTAN BOMB] Behind the stage of ‘고민보다Go' (heart ver.) @2017 MBC 가요대제전 - BTS (방탄소년단)	aZsNTviNTfU
[BANGTAN BOMB] V&Jungkook Singing at standby time - BTS (방탄소년단)	3-FXW0CW_8o
[BANGTAN BOMB] BTS with Special MC Jin @2017 KBS 가요대축제 - BTS (방탄소년단)	WBa75A4KWtM
[BANGTAN BOMB] 'MIC Drop' Special Stage (BTS focus) @MAMA - BTS (방탄소년단)	floMqK_yHf8
[BANGTAN BOMB] V’s Surprise Birthday Party - BTS (방탄소년단)	42quUBgexy0
[BANGTAN BOMB] Jin’s Surprise Birthday Party - BTS (방탄소년단)	E0rZVPFUeyg
[BANGTAN BOMB] '봄날' Special Stage (BTS focus) @MMA - BTS (방탄소년단)	Rbv8x3j72Ss
[BANGTAN BOMB] 'DNA' Special Stage (BTS focus) @MMA - BTS (방탄소년단)	TBxS2oIUUqc
[BANGTAN BOMB] Happy new year 2018! - BTS (방탄소년단)	47tC_G1DJ7M
[BANGTAN BOMB] BTS 'MIC Drop' MV reaction - BTS (방탄소년단)	HQsyxzOCuWA
[BANGTAN BOMB] '고민보다 GO (Halloween ver.)' Behind - BTS (방탄소년단)	SxVZFYbn8p0
[BANGTAN BOMB] Jimin’s Surprise Birthday Party - BTS (방탄소년단)	LVV7oD2Kmsk
[BANGTAN BOMB] Behind the stage of ‘MIC Drop’ @BTS DNA COMEBACK SHOW - BTS (방탄소년단)	xtqyE06wGPM
[BANGTAN BOMB] Again ‘No More Dream’ 2017! @BTS DNA COMEBACK SHOW - BTS (방탄소년단)	h-tRfjJz0ac
[BANGTAN BOMB] Behind the stage of ‘고민보다Go’ @BTS DNA COMEBACK SHOW - BTS (방탄소년단)	jG8NHX-W_Cc
[BANGTAN BOMB] '고민보다 GO (GOGO)' Dance Practice (Halloween ver.) - BTS (방탄소년단)	Fl54gG0B8I0
[BANGTAN BOMB] BTS ‘DNA’ 2x Dance Time @BTS COUNTDOWN - BTS (방탄소년단)	o36fxLf8n1w
[BANGTAN BOMB] 'MIC Drop' Special Stage (BTS focus.) @COMEBACK SHOW - BTS (방탄소년단)	EV-NPIGjlMw
[BANGTAN BOMB] 'I NEED U' Stage @COMEBACK SHOW 'BTS DNA' - BTS (방탄소년단)	v8fnFZBOnZc
[BANGTAN BOMB] 'DNA' Special Stage (BTS focus.) @COMEBACK SHOW - BTS (방탄소년단)	QBYbEU0vvwM
[BANGTAN BOMB] '호르몬전쟁' dance performance (Real WAR ver.)	70SMjxn4FBA
[BANGTAN BOMB] ‘No More Dream’ stage @COMEBACK SHOW ‘BTS DNA’ - BTS (방탄소년단)	ywTIg9nlqBs
[BANGTAN BOMB] ‘MIC Drop’ stage @COMEBACK SHOW ‘BTS DNA’ - BTS (방탄소년단)	8umu4kqe9ek
[BANGTAN BOMB] ‘고민보다GO’ stage @COMEBACK SHOW ‘BTS DNA’ - BTS (방탄소년단)	tucl5RQG-lI
[BANGTAN BOMB] BTS 'DNA' MV REAL reaction @6:00PM (170918) - BTS (방탄소년단)	Cx6ZYcZnoW4
[BANGTAN BOMB] 613 BTS HOME PARTY Practice - Unit stage 'SIN' - BTS (방탄소년단)	g-vMUABEdOI
[BANGTAN BOMB] 613 BTS HOME PARTY Practice - Unit stage 'R&V' - BTS (방탄소년단)	qqAGleRP3ik
[BANGTAN BOMB] 613 BTS HOME PARTY Practice - Unit stage '삼줴이(3J)' - BTS (방탄소년단)	W5JB4XsjSXY
[BANGTAN BOMB] '네시' Recording Moment for 613 BTS HOME PARTY by 'R&V' - BTS (방탄소년단)	Qr1S3QZ_rlQ
[BANGTAN BOMB] Hi~ I'm V who don't know what giving up ^ⓥ^ - BTS (방탄소년단)	qlbVM4hwuM8
[BANGTAN BOMB] Last day of '봄날(Spring Day)' stage @ Ingigayo - BTS (방탄소년단)	1UoVUe29wKs
[BANGTAN BOMB] Monitoring time after 봄날(Spring Day) stage @ 쇼! 음악중심 - BTS (방탄소년단)	htQ8cp8xx0c
[BANGTAN BOMB] BTS '봄날' Won @ Music bank (feat. 봄날 New dance by Jin) - BTS (방탄소년단)	V4_ASZuLeVk
[BANGTAN BOMB] '봄날(Spring Day)' Win & 1st place pledge @ M Countdown - BTS (방탄소년단)	BnWEomMOPG4
[BANGTAN BOMB] Jung Kook is spinning round and round - BTS (방탄소년단)	0kbsq6n7Jog
[BANGTAN BOMB] Eye contact with j-hope just for 10 seconds - BTS (방탄소년단)	zagJbD0E5_0
[BANGTAN BOMB] Jin's Face-contact time @ M countdown comeback stage of 'Spring Day' - BTS (방탄소년단)	zwjLJz-QURs
[BANGTAN BOMB] Jin's Q&A time @ M countdown comeback stage of 'Spring Day' -  BTS (방탄소년단)	kxYqQZaGmU0
[BANGTAN BOMB] Jin's chatter time @ M countdown comeback stage of 'Spring Day' - BTS (방탄소년단)	A4lA3qfbd-U
[BANGTAN BOMB] Follow Cam of 'Not Today' @ M countdown - BTS (방탄소년단)	ny245sjB6eM
[BANGTAN BOMB] 400m Relay race @ ISAC 2017 - BTS (방탄소년단)	x9bv_MxRm6s
[BANGTAN BOMB] Special Stage @ SBS 가요대전 2016 - BTS (방탄소년단)	ieaKH5fH__E
[BANGTAN BOMB] Funny Dance time @ ISAC 2017 - BTS (방탄소년단)	Wt3HJzS75nc
[BANGTAN BOMB] Happy Birthday to V @ KBS 가요대축제 2016 - BTS (방탄소년단)	5d3065_JkUM
[BANGTAN BOMB] Jung Kook went to High school with BTS for graduation! - BTS (방탄소년단)	kT0BoKiNQns
[BANGTAN BOMB] Jin, RM and j-hope Monitoring Time - BTS (방탄소년단)	IyEwzrTp4LU
[BANGTAN BOMB] stage greeting the New Year @ MBC 가요대제전 2016 - BTS (방탄소년단)	YAdrtrzGxKg
[BANGTAN BOMB] Jin's personal practice 'FIRE' @ SBS 가요대전 2016 - BTS (방탄소년단)	mPjtaFM32bQ
[BANGTAN BOMB] 'Rainism' Special stage @ MBC 가요대제전 2016 - BTS (방탄소년단)	7rfIZ66DiqE
[BANGTAN BOMB] Jimin Opening show stage @ SBS 가요대전 2016 - BTS (방탄소년단)	d64bqcsW_g0
[BANGTAN BOMB] RM & Jin Intro performance @ SBS 가요대전 2016 - BTS (방탄소년단)	4IMoFG5RlNg
[BANGTAN BOMB] '말하자면' Special stage @ MBC 가요대제전 2016 - BTS (방탄소년단)	SwiJKDDBgX0
[BANGTAN BOMB] Hobi's self camera Diary - BTS (방탄소년단)	gHi7eSIzuzc
[BANGTAN BOMB] Jin's 'Skin diving' Training @ 정글의법칙 - BTS (방탄소년단)	AGMu8tKEsI4
[BANGTAN BOMB] Ready to do 'Heart to A.R.M.Y' Mission @ Ingigayo - BTS (방탄소년단)	-gETbj8QmOM
[BANGTAN BOMB] Message to A.R.M.Y as '피 땀 눈물' last day - BTS (방탄소년단)	vqmlGp54Of0
[BANGTAN BOMB] Happy new year 2017! - BTS (방탄소년단)	ALMWtt8cGm8
[BANGTAN BOMB] V's new game (Feat. a water bottle) - BTS (방탄소년단)	8LKZLbFvYeE
[BANGTAN BOMB] Mission! Make Jung Kook laugh! - BTS (방탄소년단)	kAnTcz1cCAQ
[BANGTAN BOMB] 'Blood Sweat & Tears' 2nd Win @ Music Bank - BTS (방탄소년단)	1bQdiZvhOCg
[BANGTAN BOMB] j-hope&JungKook Show Music core Special MC - BTS (방탄소년단)	hddEGPIWKmQ
[BANGTAN BOMB] Jin&Jimin M countdown Special MC - BTS (방탄소년단)	wihUzbeLMM8
[BANGTAN BOMB] S-O-P-E Debut stage practice 'お疲れさまでした' - BTS (방탄소년단)	Ye_GwXxnHnw
[BANGTAN BOMB] Eat Jin @ BANGTAN BOMB - BTS (방탄소년단)	vxboKAqdUZs
[BANGTAN BOMB] Archery episode @ 2016 ISAC - BTS (방탄소년단)	LSWyReL-2bE
[BANGTAN BOMB] Practicing Archery @ 2016 ISAC - BTS (방탄소년단)	GWQMXVD0ycU
[BANGTAN BOMB] 'WINGS' Short Film Special - Begin (Crying JK) - BTS (방탄소년단)	4Cgyo5NwRTU
[BANGTAN BOMB] 'WINGS' Short Film Special - Lie (Jimin solo dance) - BTS (방탄소년단)	IUhmH7Qqkso
[BANGTAN BOMB] 'WINGS' Short Film Special - Stigma (Camera Director: V) - BTS (방탄소년단)	mCC9c8mrgs0
[BANGTAN BOMB] 'WINGS' Short Film Special - First Love (SUGA's Playing the piano) - BTS (방탄소년단)	GMuJf6_eUOs
[BANGTAN BOMB] 'WINGS' Short Film Special - Reflection (Power Monster) - BTS (방탄소년단)	-dRafSywUSg
[BANGTAN BOMB] 'WINGS' Short Film Special - MAMA (Acting j-hope) - BTS (방탄소년단)	_X19yd9BIao
[BANGTAN BOMB] 'WINGS' Short Film Special - Awake (Jin lip-sync) - BTS (방탄소년단)	6rwe_Fbbg9k
[BANGTAN BOMB] V's monitoring After Show Music Core Stage - BTS (방탄소년단)	eswnQ8T0pHo
[BANGTAN BOMB] checking out the interview script after camera rehearsal @ Ingigayo - BTS (방탄소년단)	sbIQaO3kps8
[BANGTAN BOMB] Jimin’s best dance imitation by Jung Kook - BTS (방탄소년단)	Q2ddFsSwqLQ
[BANGTAN BOMB] This is how V warms up his voice before singing - BTS (방탄소년단)	X2swBKi3Sxg
[BANGTAN BOMB] Jimin's selfie cam – interview time with BTS - BTS (방탄소년단)	7xJd7cu6-fY
[BANGTAN BOMB] Heart performance with '피 땀 눈물' - BTS (방탄소년단)	-McjPcmVE6k
[BANGTAN BOMB] Sweet Jin & Jung KOOK 's chatter - BTS (방탄소년단)	8oko4a0xIxY
[BANGTAN BOMB] '21세기 소녀 (21st Century Girl)' Dance Practice (Halloween ver.) - BTS (방탄소년단)	6tUumjx2BWw
[BANGTAN BOMB] V's message to A.R.M.Y - BTS (방탄소년단)	qA1rMopSvrQ
[BANGTAN BOMB] Happy Birthday song for JIMIN (21세기 소녀) - BTS (방탄소년단)	Hk9_zjVhI3A
[BANGTAN BOMB] Jimin's Birthday at M countdown - BTS (방탄소년단)	IgR7AZ90LL4
[BANGTAN BOMB] '피 땀 눈물' MV Reaction by BTS - BTS (방탄소년단)	fhHcgbFN_rg
[BANGTAN BOMB] Concept trailer practice - BTS (방탄소년단)	XxGun4QQDz0
[BANGTAN BOMB] Today's Letter deliverer Jimin! - BTS (방탄소년단)	CitzoKwUxNk
[BANGTAN BOMB] BTS stretching Time - BTS (방탄소년단)	ukBl3SfE8TE
[BANGTAN BOMB] JK's chatter : BTS Band? - BTS (방탄소년단)	VdjXDRuiJc8
[BANGTAN BOMB] V's Dream came true - 'His Cypher pt.3 Solo Stage' - BTS (방탄소년단)	GQ0XGbHjKRE
[BANGTAN BOMB] RM and Jin Dance Stage Behind the scene for BTS DAY PARTY 2016 - BTS (방탄소년단)	t0oGvUjyJgU
[BANGTAN BOMB] 'Coming of age ceremony' Dance cover by Jimin & Jung Kook - BTS (방탄소년단)	D4oIpsRemPA
[BANGTAN BOMB] BTS' Vocal Duet 'SOPE-ME' Stage behind the scene - BTS (방탄소년단)	nac1hoha570
[BANGTAN BOMB] JK's chatter: My baggy pants.... - BTS (방탄소년단)	rwtPIx9lE4c
[BANGTAN BOMB] Jimin makes a quatrain with Jin & JK - BTS (방탄소년단)	nHbibsdemlI
[BANGTAN BOMB] Jin & Kook Massage Time - BTS (방탄소년단)	9MHnNAT3SBQ
[BANGTAN BOMB] BTS' Relay race @ 2016 추석특집 아육대 - BTS (방탄소년단)	0gqOz1OO-88
[BANGTAN BOMB] Jimin & Jung Kook did 'Show Music Core' Special MC!! - BTS (방탄소년단)	HcUUBgnHb9U
[BANGTAN BOMB] j-hope & V did Ingigayo Special MC!! - BTS (방탄소년단)	VnN8Yi0-utk
[BANGTAN BOMB] Free dance time with JIMIN & V - BTS (방탄소년단)	Up5AlMj_rRM
[BANGTAN BOMB] Stretching Time before Dance scene @ 'FIRE' MV - BTS (방탄소년단)	jq_0_xhn6Pc
[BANGTAN BOMB] Dart King Jung Kook - BTS (방탄소년단)	GXTJ7r_QUKY
[BANGTAN BOMB] Moni & Mini wearing twin-look - BTS (방탄소년단)	-rJJKJCPGI4
[BANGTAN BOMB] 3:33 BTS ver. - BTS (방탄소년단)	8_Ct3zX69EE
[BANGTAN BOMB] Professional 'Kim Daily' Photographer - BTS (방탄소년단)	0AEEVoMgv8I
[BANGTAN BOMB] what a cute boy, j-hope! :-p - BTS (방탄소년단)	PJQ3PEYU7x8
[BANGTAN BOMB] Arirang arirang~Arariyo~~ - BTS (방탄소년단)	FIboLdbZMEA
[BANGTAN BOMB] at 5th GAON CHART K-POP Awards - BTS (방탄소년단)	1h8BBT05Oyo
[BANGTAN BOMB] the challenge to 'Ssireum(Korean Wrestling)' - BTS (방탄소년단)	vztlAuT7EFg
[BANGTAN BOMB] The Amazing Spider-kook..! - BTS (방탄소년단)	c4EdaCNkG3Q
[BANGTAN BOMB] Dancing with Rain - BTS (방탄소년단)	5GG2f8InD6U
[BANGTAN BOMB] 'FIRE' MV Shooting - Free gesture Time -  BTS (방탄소년단)	_8KR2pxyZ-Y
[BANGTAN BOMB] Special BANGTAN BOMB 10- We are bulletproof - BTS (방탄소년단)	nRytjCUd0_g
[BANGTAN BOMB] Special BANGTAN BOMB 9 - lip-sync Big Hit Christmas carol - BTS (방탄소년단)	PKXMq0wtT1c
[BANGTAN BOMB] Special BANGTAN BOMB 8- Playing the guitar - BTS (방탄소년단)	cZltJ6QnFjA
[BANGTAN BOMB] Special BANGTAN BOMB 7- Jimin is elder than JK LOL - BTS (방탄소년단)	iVOqP8_AFDA
[BANGTAN BOMB] Special BANGTAN BOMB 6- Jin's practice before the shooting - BTS (방탄소년단)	uJgb6r8eShU
[BANGTAN BOMB] Special BANGTAN BOMB 5 - Let's make an autograph! - BTS (방탄소년단)	pQ8rGU8BsS0
[BANGTAN BOMB] Special BANGTAN BOMB 4- SUGA's Solo cut shooting - BTS (방탄소년단)	GT_hEsfAVW8
[BANGTAN BOMB] Special BANGTAN BOMB 3- j-hope & JK at MV shooting - BTS (방탄소년단)	c7tNVKLKQjw
[BANGTAN BOMB] Special BANGTAN BOMB 2 - RM's solo cut shooting - BTS (방탄소년단)	1mnvkbMbaqw
[BANGTAN BOMB] Special BANGTAN BOMB 1- Jimin & V 's Self Camera - BTS (방탄소년단)	Rb_1loGFgYI
[BANGTAN BOMB] '뱁새' Dance Practice (흥 ver.) - BTS (방탄소년단)	V1i_x2_TGE0
[BANGTAN BOMB] 3:33 Jimin - BTS (방탄소년단)	ETjKzY1TWJE
[BANGTAN BOMB] Ingigayo 1st win and Jin & RM Special MC - BTS (방탄소년단)	RunVSO5boUU
[BANGTAN BOMB] 'Show! Music Core' Special MC Jung kook! - BTS (방탄소년단)	5Iw3LPrSAwk
[BANGTAN BOMB] 'FIRE' MV Shooting- 'JIMIN' Follow ver. -  BTS (방탄소년단)	Jb5f3HkbDOk
[BANGTAN BOMB] 'FIRE' MV Shooting- 'JK' Follow ver. - BTS (방탄소년단)	cFCd5Tr_9nE
[BANGTAN BOMB] 'FIRE' MV Shooting- 'RM' Follow ver. - BTS (방탄소년단)	IvKjYgJHVk8
[BANGTAN BOMB] 'FIRE' MV Shooting- 'V' Follow ver. - BTS (방탄소년단)	RzaBLjJUo4I
[BANGTAN BOMB] 'FIRE' MV Shooting- 'Jin' Follow ver. - BTS (방탄소년단)	XL-6JZjRov0
[BANGTAN BOMB] 'FIRE' MV Shooting- 'SUGA' Follow ver. - BTS (방탄소년단)	QrbiWWUM5QQ
[BANGTAN BOMB] 'FIRE' MV Shooting- 'j-hope' Follow ver. - BTS (방탄소년단)	ARps1jfmxns
[BANGTAN BOMB] 'Hand In Hand' @ ISAC 2016 - BTS (방탄소년단)	fUmnjAvbDcE
[BANGTAN BOMB] j-hope is trying to wear contact lenses. - BTS (방탄소년단)	Ek3EC9lA6X0
[BANGTAN BOMB] Snowball fight (Jimin's cam) - BTS (방탄소년단)	vGQTrW5lJCw
[BANGTAN BOMB] Jung Kook's shopping - BTS (방탄소년단)	jeSxXDe89VM
[BANGTAN BOMB] Actor Kim with Kook PD - BTS (방탄소년단)	rc-YuESVHnA
[BANGTAN BOMB] at the 30th Golden Disc Awards 2016 - BTS (방탄소년단)	rjRLLd-fMG4
[BANGTAN BOMB] Show Me Your BBA SAE!?!? - BTS (방탄소년단)	ttSLLgU8F_I
[BANGTAN BOMB] 영화 '순정' VIP preview with Jin - BTS (방탄소년단)	b13mf_sQtb4
[BANGTAN BOMB] Jung Kook is still a baby.... - BTS (방탄소년단)	dYYu-RScKgw
[BANGTAN BOMB] j-hope's singing 'RUN' over a loudspeaker - BTS (방탄소년단)	2A9UmF_kxm4
[BANGTAN BOMB] BTS (방탄소년단) Jimin's singing 'Butterfly' over a loudspeaker	G-KJu3Ahv6c
[BANGTAN BOMB] BTS (방탄소년단) SUGA is trying to wear contact lenses.	7hhG5wCHh9M
[BANGTAN BOMB] BTS (방탄소년단) Perfect boys 2015	SgVDQGbnxiM
[BANGTAN BOMB] BTS (방탄소년단) Dessert time @-@	JlJjbFTDmn0
[BANGTAN BOMB] BTS (방탄소년단) Became an archer! SUGA & JIMIN's new challenge for ISAC	k__23bghbqg
[BANGTAN BOMB] BTS (방탄소년단) a 400-meter relay race @ 2016 설특집 아육대	9J-yfCdBbIY
[BANGTAN BOMB] Rap Monster on the Speicial stage 'Buckubucku(부끄부끄)' feat.BTS - BTS (방탄소년단)	6r0n1HOFvv0
[BANGTAN BOMB] Jimin drawing a piano for SUGA - BTS (방탄소년단)	HFoQ93MuGA4
[BANGTAN BOMB] Jung Kook collaboration stage with Zion.T - BTS (방탄소년단)	RhdS31XhT7c
[BANGTAN BOMB] Backstage @ KBS song Festival 2015 - BTS (방탄소년단)	m6Y4DDoZIM4
[BANGTAN BOMB] Hide and seek with JM, V, JK (#2)	gzDad3RXSks
[BANGTAN BOMB] Hide and seek with JM, V, JK (#1)	AL8IA6K3iP0
[BANGTAN BOMB] BTS 5th Win @ real last day of 'RUN' - BTS (방탄소년단)	G0_KMvLLPwA
[BANGTAN BOMB] Happy new year 2016! - BTS (방탄소년단)	mObY5pPkooo
[BANGTAN BOMB] sleepy j-hope - BTS (방탄소년단)	vKw-bfVpi90
[BANGTAN BOMB] Sleeping Baby bothered with Jin - BTS (방탄소년단)	-0zrjdzM2rU
[BANGTAN BOMB] 'RUN' christmas ver.	sjwrE0I-cXM
[BANGTAN BOMB] 2 brushes for Jung Kook's teeth - BTS (방탄소년단)	659w_0Oq5Vc
[BANGTAN BOMB] Playing the rhythm game (..and V's making a song) - BTS (방탄소년단)	ewhMYO3AEs4
[BANGTAN BOMB] Jimin's self camera (RUN 151204 ver.) - BTS (방탄소년단)	7-sg7XZ9gbI
[BANGTAN BOMB] Ingigayo Special MC debut Rap Monster - BTS (방탄소년단)	GywH4KNPmaY
[BANGTAN BOMB] Music bank special MC V - BTS (방탄소년단)	9XvRNeu5sls
[BANGTAN BOMB] Know-how for making a handsome look (bonus. Mr.lip balm-JK) - BTS (방탄소년단)	IvVxru4SOTQ
[BANGTAN BOMB] Jimin self cam with A.R.M.Y - BTS (방탄소년단)	lU0DEUtiOqI
[BANGTAN BOMB] Shooting guard SUGA with cheerleader 2 Jimin -  BTS (방탄소년단)	4NZj_ckavvE
[BANGTAN BOMB] a 400-meter relay race @ 아육대	9ZQ5koAQCtw
[BANGTAN BOMB] Cheerleader jin with ARMY Bomb ─○"	4hmTqyjT7L4
[BANGTAN BOMB] who is the wave Dance king of BTS? - BTS (방탄소년단)	GtFP7HBksB8
[BANGTAN BOMB] Happy barbecue dance Performance - BTS (방탄소년단)	zuHJg7bTko0
[BANGTAN BOMB] Becoming younger brother  - BTS (방탄소년단)	msLBhqAf3VA
[BANGTAN BOMB] It's the pose when BTS sleep normally	Y-EmkILnUZs
[BANGTAN BOMB] look their face over using the camera lol - BTS (방탄소년단)	O5QtsM7YK8U
[BANGTAN BOMB] Boys over Flowers - BTS (방탄소년단)	UJyLFHcz3QA
[BANGTAN BOMB] Let's dry hair ~ lalalalalala~ - BTS (방탄소년단)	Cjp3pAlcooE
[BTS in NAVER STAR CAST] 남한산성	9G87g_MvVQU
[BANGTAN BOMB] Jimin: I got yes jam	e4S9czAIF40
[BANGTAN BOMB] Singer j-hope & SUGA - BTS (방탄소년단)	ZQmW40LSMKE
[BANGTAN BOMB] Bike Rider - BTS (방탄소년단)	kfWORwAUFYU
[BANGTAN BOMB] Jung Kook with Fun - BTS (방탄소년단)	QfzlTd9EXlM
[BANGTAN BOMB] Jung Kook PD's directing - BTS (방탄소년단)	5VFtCFs9N1w
[BANGTAN BOMB] Let's learn point dance with V - BTS (방탄소년단)	jegR-MlR440
[BANGTAN BOMB]  j-hope's automatic awareness CAM of BTS (방탄소년단)	8QBJzAikyK4
[BANGTAN BOMB] omg j-hope world aegyo king (with V) - BTS (방탄소년단)	YbUzeb37WpU
[BANGTAN BOMB] j-hope's gesture at 'DOPE' MV  - BTS (방탄소년단)	s3qqRG-Vcj4
[BANGTAN BOMB] JungKook's CUPID shot- O MY Seagull ! - BTS (방탄소년단)	j3uTksuFDD0
[BANGTAN BOMB] j-hope&Jimin's 'DOPE' Music Video Reaction - BTS (방탄소년단)	mXsOyT3eOrw
[BANGTAN BOMB] SUGA&Rap Monster's special collaboration stage @Dream Concert - BTS (방탄소년단)	2aBzCpLfsjw
[BANGTAN BOMB] j-hope's solo special Dance stage @Dream Concert - BTS (방탄소년단)	gHjCL6wl3D8
[BANGTAN BOMB] BTS Waking-up HOBI CAM @Dream concert	4CMMeDZGP5w
[BANGTAN BOMB] 1st meeting with Seolbing ?! - BTS (방탄소년단)	caRa2z8iv1U
[BANGTAN BOMB] UP down UP UP down @ Dream concert - BTS (방탄소년단)	HCBWoMRlLCE
[BANGTAN BOMB] Facial muscles exercise time in the car - BTS (방탄소년단)	97Evoac8PKk
[BANGTAN BOMB] Last day of 'I NEED U' stage @ Ingigayo	D2i_2PBZGww
[BANGTAN BOMB] very handsome boy Jimin - BTS (방탄소년단)	eXLmK-sJC8c
[BANGTAN BOMB] Recording I NEED U chorus in BTS choir - BTS (방탄소년단)	KVdUl0U18Mc
[BANGTAN BOMB] V's trot medley on the move to MV shooting place - BTS (방탄소년단)	aFxbiaEMUp0
[BANGTAN BOMB] Jung Kook's self-cam with seagull in the sea (Jacket Shooting) - BTS (방탄소년단)	Ca4s-zgKs4E
[BANGTAN BOMB] after KBS Music Bank 1st Place - BTS (방탄소년단)	UV3vIYdTNIU
[BANGTAN BOMB] after M!countdown 1st place T_T - BTS (방탄소년단)	oMPRPKjCMQs
[BANGTAN BOMB] BTS rookie Camera Director Jung Kookie :D - BTS (방탄소년단)	mccmZGkrU_k
[BANGTAN BOMB] Only j-hope's New Year's greeting - BTS (방탄소년단)	fj3-s_V1AB8
[BANGTAN BOMB] BTS Multiplication table Game! - BTS (방탄소년단)	GpHRW6RMz6Q
[BANGTAN BOMB] BTS' rhythmical farce! LOL - BTS (방탄소년단)	Etv1TDuI7UM
[BANGTAN BOMB] V took a A.R.M.Y Bomb(Fan light)! - BTS (방탄소년단)	tCUoMU0UwQk
[BANGTAN BOMB] BTS Jenga championship thanks to Twitter	PX5dlXLxPSI
[BANGTAN BOMB] j-hope's RoboCop Jimin - BTS (방탄소년단)	CB2ESOlX83M
[BANGTAN BOMB] UP DOWN UP UP DOWN (by EXID)	5gEqOtODMH4
[BANGTAN BOMB] Touch my body~ body~  j-hope likes this song! - BTS (방탄소년단)	xWbGvuA50ps
[BANGTAN BOMB] j-hope vs 95z - BTS (방탄소년단)	30OTTR5quIY
[BANGTAN BOMB] it's tricky is title! BTS, here we go! (by Run–D.M.C.)	PSdgzdDMIeE
[BANGTAN BOMB] BTS at the 4th Gaon chart Awards 2015 - BTS (방탄소년단)	WTv2ys9j-b0
[BANGTAN BOMB] Forest of Dreams(by Kinetic Flow) in Beijing	_vPOsy12LZE
[BANGTAN BOMB] Jin and Jimin's Push-up time 2 - BTS (방탄소년단)	4fWfdhTw_BI
[BANGTAN BOMB] the 29th Golden Disc Awards in Beijing (BTS Self cam.) - BTS (방탄소년단)	AJYtPq9lXoo
[BANGTAN BOMB] BTS at the 24th Seoul Music Awards - BTS (방탄소년단)	hrNh55lbHvU
[BANGTAN BOMB] Jin and Jimin's Push-up time - BTS (방탄소년단)	nO345gv1AwA
[BANGTAN BOMB] always rhythmically! - BTS (방탄소년단)	qm_Vwbni7Wo
[BANGTAN BOMB] 2015.01.01, After countdown event - BTS (방탄소년단)	iQrApUyJf3U
[BANGTAN BOMB] 95z dance time with a Beat app - BTS (방탄소년단)	7jEF7ehSeY8
[BANGTAN BOMB] follow BTS! 2222 (Jimin Cam)	wS2Fo8gYBdM
[BANGTAN BOMB] like in a singing room - BTS (방탄소년단)	Q0Z41us9Qws
[BANGTAN BOMB] Practicing for Show Music core 'special MC' - BTS (방탄소년단)	j0fw1WEmhns
[BANGTAN BOMB] MAL dance made by j-hope - BTS (방탄소년단)	z238WcoR1-U
[BANGTAN BOMB] Finding Jung Kook by Jimin PD (2) - BTS (방탄소년단)	AOlAASPykp8
[BANGTAN BOMB] Rap Monster's performance class - BTS (방탄소년단)	SyX_d4d3hnI
[BANGTAN BOMB] Who are Elders in BTS? lol - BTS (방탄소년단)	KlIHKbJ61FU
[BANGTAN BOMB] Someone like you (sung & produced by V)	56jN9-cMEBU
[BANGTAN BOMB] What Jimin wants to say to j-hope is.... - BTS (방탄소년단)	NKYHDUHdINg
[BANGTAN BOMB] 'A guy like me' lip-sync by JungKook (V cam)	Xvi_0ujZpTs
[BANGTAN BOMB] one part repeated practice (-loop) - BTS (방탄소년단)	pQYk_LKFKiE
[BANGTAN BOMB] Lalalalalalalala OK! perform by Jin & Mon - BTS (방탄소년단)	zArff0jMThM
[BANGTAN BOMB] BTS' Stream of consciousness Bomb - BTS (방탄소년단)	0apMWptmpQs
[BANGTAN BOMB] j-hope's exercise - BTS (방탄소년단)	a2TsLa5StK0
[BANGTAN BOMB] Pretty Age 25 (turn up!) - BTS (방탄소년단)	V3hxqjapIVI
[BANGTAN BOMB] Hi~Camera~ This.....?? - BTS (방탄소년단)	hXyvUScpCAQ
[BANGTAN BOMB] what are BTS members doing? (j-hope cam) - BTS (방탄소년단)	Rpib1e0SnOg
[BANGTAN BOMB] V's monologue - BTS (방탄소년단)	UnFzmMaiSFs
[BANGTAN BOMB] lip sync princes - BTS (방탄소년단)	YkZlCUrtaaA
[BANGTAN BOMB] Beautiful (BTS ver.) - BTS (방탄소년단)	TZnNlJXyswU
[BANGTAN BOMB] SUGA's sleep mate - BTS (방탄소년단)	TdCLa9lIyEE
[BANGTAN BOMB] follow BTS! (j-hope Cam)	Ry4nTUzdKcU
[BANGTAN BOMB] how to take a selfie - BTS (방탄소년단)	bPhuBB1b5vw
[BANGTAN BOMB] Enjoy 2014 Halloween	dM-tG7B0p4c
[BANGTAN BOMB] Rapmon's Dance lesson - BTS (방탄소년단)	HM0_GT9flaA
[BANGTAN BOMB] War of hormone  in Halloween	ZxEly3yz-1g
[BANGTAN BOMB] Jimin is on the phone with Ms.A.R.M.Y. - BTS (방탄소년단)	ZrA6Oq94Cjo
[BANGTAN BOMB] BTS Cypher Fan no.1 V - BTS (방탄소년단)	KJljGcOOLrg
[BANGTAN BOMB] Dance #2 Wiggle!	NK2DefWDAl0
[BANGTAN BOMB] Dance #1. Drop That NaeNae!	8pS8MrNQr_I
[BANGTAN BOMB] While You Were Sleeping - BTS (방탄소년단)	2eRIu8lAnZs
[BANGTAN BOMB] Hi! Let me introduce myself! - BTS (방탄소년단)	qfGrBhwgXl8
[BANGTAN BOMB] Grasping power fight with V - BTS (방탄소년단)	YJh6da3yBYI
[BANGTAN BOMB] 'Danger' last day mission - BTS (방탄소년단)	bC0jTAxhO9U
[BANGTAN BOMB] Jimin's dance detail practice - BTS (방탄소년단)	gp3QX3qKEa4
[BANGTAN BOMB] BTS got a sunglass from Mpd! - BTS (방탄소년단)	JUINrb3oHKo
[BANGTAN BOMB] SUGA's eyes & Jimin's delusion lol - BTS (방탄소년단)	nLylGXNZ-C0
[BANGTAN BOMB] SUGA free...? HOPE free..? MON free! - BTS (방탄소년단)	Pb6Db0VwWrQ
[BANGTAN BOMB] Eating salad - BTS (방탄소년단)	kSX7SU5jg3U
[BANGTAN BOMB] Hi! Hi! Hi! Hi! - BTS (방탄소년단)	3nLoaAWi1sk
[BANGTAN BOMB] recommend the songs (Selfie with VJ Kook) - BTS (방탄소년단)	Un77EigBjAk
[BANGTAN BOMB] Touch my body (of SISTAR) - BTS (방탄소년단)	kB2qn0YDTx0
[BANGTAN BOMB] stretching doing dance in BTS free time - BTS (방탄소년단)	SgCogoUecJM
[BANGTAN BOMB] SUGA free...? HOPE free!	O1E6Gkw-cMo
[BANGTAN BOMB] BTS Match! (2) hit the bottle top - BTS (방탄소년단)	JRqbLZzMOuE
[BANGTAN BOMB] BTS Match! (1) Omok (SUGA vs Jimin) - BTS (방탄소년단)	3JXBM-_fGUQ
[BANGTAN BOMB] Various beatbox by BTS (face..dog..monster..etc.) - BTS (방탄소년단)	1paQawvrXeM
[BANGTAN BOMB] BTS' selfie recording Danger - BTS (방탄소년단)	yMA2YVQymZ8
[BANGTAN BOMB] Rap Monster Birthday Tweet Relay - BTS (방탄소년단)	T8dG-i6g4Ck
[BANGTAN BOMB] 방탄도령단 - 危險 (Appeal ver.)	rvj2O-O6JGQ
[BANGTAN BOMB] Runway in the night - BTS (방탄소년단)	f1zVUalWabo
[BANGTAN BOMB] Friday & Some with BTS - BTS (방탄소년단)	FptA2OGnhNo
[BANGTAN BOMB] Before BTS Special stage - BTS (방탄소년단)	Tp5p95PJtKc
[BANGTAN BOMB] What am I to you? - BTS (방탄소년단)	BgHgLZlJOOU
[BANGTAN BOMB] Play to become the famous Artists!  - BTS (방탄소년단)	1lxRJYMBoCs
[BANGTAN BOMB] You're a holiday , such a holiday~ (Bee Gees - Holiday) - BTS (방탄소년단)	QAyhxF418oc
[BANGTAN BOMB] BTS run way ! (95z cam #2) - BTS (방탄소년단)	QzSSojnPl98
[BANGTAN BOMB] Let's speak English!	cDlSqljhHD0
[BANGTAN BOMB] Nick Name T-shirts! (95z cam #1)	hzRaOnTSIG4
[BANGTAN BOMB] SUGA's way to make a 'ssam' fast! - BTS (방탄소년단)	2vASJOQq900
[BANGTAN BOMB] 눈,코,입 (EYES, NOSE, LIPS) of Jung Kook (Feat.Jimin)	ZVVH--7P-t8
[BANGTAN BOMB] 눈,코,입 (EYES, NOSE, LIPS) of BTS	J8uOSITy1t0
[BANGTAN BOMB] Whatcha Doin' Today?	YIds9C6pjos
[BANGTAN BOMB] V's magic - BTS (방탄소년단)	5SOkUNQIAnM
[BANGTAN BOMB] Finding Jung Kook by Jimin PD - BTS (방탄소년단)	mn6JrXmLdsU
[BANGTAN BOMB] ZzzzzZ....Z....zz...zzzZ - BTS (방탄소년단)	FWGmefB5bwo
[BANGTAN BOMB] Something ver.2 by Rap Monster, Jimin, Jin and j-hope! - BTS (방탄소년단)	2xMhlTot6TM
[BANGTAN BOMB] The reason why Jung Kook & Jin did running - BTS (방탄소년단)	tCIzlE3JpyE
[BANGTAN BOMB] suddenly Rap party - BTS (방탄소년단)	QlmgznLNVu8
[BANGTAN BOMB] Always happy happy boy, j-hope! - BTS (방탄소년단)	c2dvXQwmckc
[BANGTAN BOMB] medley show time! (performed by BTS)	heTHSxEJIew
[BANGTAN BOMB] Jimin's kiwi juice CF (narration by j-hope) - BTS (방탄소년단)	MxyJPlSk-mc
[BANGTAN BOMB] Let's test BTS' nerve!	NOhsj0eMcXc
[BANGTAN BOMB] Full moon(of Sunmi) cover ver. by BTS (방탄소년단)	y7jFW1XcBao
[BANGTAN BOMB] The way to express the music '썸(Some)' of SoYou&JunggiGo - BTS (방탄소년단)	39ISVcNIrys
[BANGTAN BOMB] 'Just one day' practice (Appeal ver.)	zNJMa43UVs0
[BANGTAN BOMB] After Show champion special stage - BTS (방탄소년단)	s-TTuilIFx8
[BANGTAN BOMB] 'This Love' practice for Show Champion	rExay43Ro28
[BANGTAN BOMB] BTS Cypher ver. Jung Kook & V - BTS (방탄소년단)	x9rBXOSFSe8
[BANGTAN BOMB] angry j-hope LOL - BTS (방탄소년단)	Nwq75jE24sE
[BANGTAN BOMB] Rap making by Jimin & Jung Kook - BTS (방탄소년단)	hSDh2HXdtQw
[BANGTAN BOMB] Jutti Meri Oye~ Hoi~ Hoi~ (Catallena of Orange Caramel) - BTS (방탄소년단)	uSVxNc7O36o
[BANGTAN BOMB] V is wearing BOMB..?- BTS (방탄소년단)	IrsV7pxNHGk
[BANGTAN BOMB] 'You don't love me of SPICA' dance by BTS	n-CzPIaJF-A
[BANGTAN BOMB] Jung Kook's Dance guide - BTS (방탄소년단)	dznnEUOSW4Q
[BANGTAN BOMB] V's Change Magic show! - BTS (방탄소년단)	t6Gb7rVah6E
[BANGTAN BOMB] 'Don't tease me' dance by BTS (방탄소년단)	8mXTkoxFQoE
[BANGTAN BOMB] Something by Jung kook, Jimin and JIN - BTS (방탄소년단)	oN-NnNdfBhU
[BANGTAN BOMB] Why are you shaking my heart? - V show time! - BTS (방탄소년단)	R19nry0tX6s
[BANGTAN BOMB] SUGA on the basketball hoop - BTS (방탄소년단)	wlLDRWz6Pvw
[BANGTAN BOMB] Battle of acting charming - BTS (방탄소년단)	kjDJR5lkiZ4
[BANGTAN BOMB] when BTS was practicing the showcase	QKeXCmmpk28
[BANGTAN BOMB] Boy's confessions by their own way - BTS (방탄소년단)	mL2W4uqFHMc
[BANGTAN BOMB] Welcome to BTS Class, Mr. Camera! - BTS (방탄소년단)	b2HW2rFpedI
[BANGTAN BOMB] Hello, Jin! - BTS (방탄소년단)	Ydz5rcEkuFo
[BANGTAN BOMB] Free Dance Time in front of A.R.M.Y _140113 - BTS (방탄소년단)	OvhTNVyxTpA
[BANGTAN BOMB] Let's intercept SUGA! - BTS (방탄소년단)	pYd3rqxPG6k
[BANGTAN BOMB] before last stage of Japan showcase - BTS (방탄소년단)	Towm2Iqm4lE
[BANGTAN BOMB] Do you know 'Clon - Kung Ddari Sha Bah Rah'? - BTS (방탄소년단)	DazoanKQfKE
[BANGTAN BOMB] Just watching Jung Kook lip sync show	0-XR2iLEUQY
[BANGTAN BOMB] Hanbok dance time (shooting by Jimin) - BTS (방탄소년단)	JamUN0W707E
[BANGTAN BOMB] Jump! Jimin entered the high jump!	ivjnwAR91Sk
[BANGTAN BOMB] Show your feelings by using your body! - BTS (방탄소년단)	5inzqW7gIaw
[BANGTAN BOMB] Drawing their 2014! - BTS (방탄소년단)	E0JgpDCg5gs
[BANGTAN BOMB] Show your powerful sexy wave! - BTS (방탄소년단)	E5QwpgNPLWs
[BANGTAN BOMB] V is doing weird dance  - BTS (방탄소년단)	oKfRBMJb5Zk
[BANGTAN BOMB] Trot rookies on standby time of rehearsal - BTS (방탄소년단)	HHHRfKyQc9c
[BANGTAN BOMB] BTS in the 28th Golden Disk Awards - BTS (방탄소년단)	QsQQfJRjD48
[BANGTAN BOMB] RINGA LINGA (by TAEYANG of BIGBANG) DANCE PARTY	5MS31Qr23Ic
[BANGTAN BOMB] Jungkook...Jimin is elder than you LOL - BTS (방탄소년단)	1MHRYNiPt_I
[BANGTAN BOMB] BTS on runway like Model - BTS (방탄소년단)	FSeQhLb6gyo
[BANGTAN BOMB] V's birthday episode - BTS (방탄소년단)	PQxb1UdHHmc
[BANGTAN BOMB] 2014 New year's greeting from BTS - BTS (방탄소년단)	KhQS7eFUPu8
[BANGTAN BOMB] Dancing by Jimin & shooting by Jung Kook - BTS (방탄소년단)	6FHHCUYcQrQ
[BANGTAN BOMB] Sudden...Suddenly attack! - BTS (방탄소년단)	snRd8bErrzk
[BANGTAN BOMB] BTS Magic show - BTS (방탄소년단)	VNfRVWGi-YQ
[BANGTAN BOMB] Movie Director Jung Kook - BTS (방탄소년단)	Foxi_McXzUo
[BANGTAN BOMB] Photographer j-hope & Jung Kook lol - BTS (방탄소년단)	xH1OXsXJIec
[BANGTAN BOMB] BTS likes 문을 여시오 (Open the Door) of 임창정 - BTS (방탄소년단)	Mh1d82riryY
[BANGTAN BOMB] Jimin's Sexy dance one point lesson	iHc7a8lHOGM
[BANGTAN BOMB] Attack on BTS at dance practice 2 - BTS (방탄소년단)	7PE_zqQPHd4
[BANGTAN BOMB] BTS Style 'NO.9' of T-ara at the ready time - BTS (방탄소년단)	ECjXyrtE24s
[BANGTAN BOMB] Do you know how to bounce?	XS8nWfYk3gw
[BANGTAN BOMB] Jin's Bithday party (shooting by V PD) - BTS (방탄소년단)	0HIjeZge6JA
[BANGTAN BOMB] Practicing Special MC ment - BTS (방탄소년단)	UsGRoMgiGIA
[BANGTAN BOMB] V's solo dance in the night - BTS (방탄소년단)	NQdM-6YKT_o
[BANGTAN BOMB] Rap Monster's Change Magic show! - BTS (방탄소년단)	d0AGo6-r7uI
[BANGTAN BOMB] BTS style 'Hush' of Miss A	ilwmwPxpKLg
[BANGTAN BOMB] Hunter Jungkook and V rabbit - BTS (방탄소년단)  - BTS (방탄소년단)	y6OmUIERrfQ
[BANGTAN BOMB] Dancing Machine ohohoh - BTS (방탄소년단)	nuFvRLO0Ymo
[BANGTAN BOMB] Attack on BTS at dance practice	kuc2TrjfOHo
[BANGTAN BOMB] N.O last day! - BTS (방탄소년단)	VYpUkmIsWoE
[BANGTAN BOMB] taking a twitter group picture! - BTS (방탄소년단)	cvsuQNeyp1g
[BANGTAN BOMB] Focus on Jimin's come-hither look - BTS (방탄소년단)	qb0e7X0_LmM
[BANGTAN BOMB] V thinks Jungkook like baby! lol - BTS (방탄소년단)	jKNMRm64GfM
[BANGTAN BOMB] naughty boys V & Jimin! - BTS (방탄소년단)	xbmTZglkSgQ
[BANGTAN BOMB] BTS N.O lip-sync...? Dance..? - BTS (방탄소년단)	JYPzN6qt9Ho
[BANGTAN BOMB] Kings of Jump rope - BTS (방탄소년단)	aKWEK07c9ZE
[BANGTAN BOMB] Rapper Jimin & V and Rap monster! - BTS (방탄소년단)	greZdsISDQY
[BANGTAN BOMB] Curious Cute Rapmonster & j-hope - BTS (방탄소년단)	hNHTl1rBI0I
[BANGTAN BOMB] N.O (Trot ver.) by Jungkook and (Opera ver.) by BTS	Qs2unC6IwBc
[BANGTAN BOMB] j-hope's 'Push push' dance - BTS (방탄소년단)	xbscpcUGd2c
[BANGTAN BOMB] V's dance with 'kkomul kkomul' song	8yJnyilQAJA
[BANGTAN BOMB] Congratulations to Jimin! - BTS (방탄소년단)	5M9ruwJIaXs
[BANGTAN BOMB] Saturday dancing time! - BTS (방탄소년단)	OpKUc8IeUrc
[BANGTAN BOMB] NEW BTS Uniform - BTS (방탄소년단)	yV1r9Kdqot0
[BANGTAN BOMB] BTS does a funny imitation of V. - BTS (방탄소년단)	-1MQUQAPsK0
[BANGTAN BOMB] Sleeping boys - BTS (방탄소년단)	84wa1B7l3rM
[BANGTAN BOMB] Shy shy shy JungKook - BTS (방탄소년단)	2nZq1nqH_I0
[BANGTAN BOMB] Jimin's 'GIRL'S DAY- FEMALE PRESIDENT' dance	QUry0K0KE78
[BANGTAN BOMB] Singing at standby time - BTS (방탄소년단)	Czo5owjVApg
[BANGTAN BOMB] 1st Minialbum Comeback feeling - BTS (방탄소년단)	nkWtzugXJtY
[BANGTAN BOMB] Sleeping beau...ty! - BTS (방탄소년단)	bfEUTthX-us
[BANGTAN BOMB] j-hope & Jungkook are Rapper! - BTS (방탄소년단)	yJHIMADPtno
[BANGTAN BOMB] BTS Dance time - BTS (방탄소년단)	cQ9Qv_D99Ug
[BANGTAN BOMB] BTS like BAAAM of Dynamic Duo - BTS (방탄소년단)	3oTqFEx_C2s
[BANGTAN BOMB] Q&A Time in yellow post-it Room - BTS (방탄소년단)	ZuK6GtNtoQY
[BANGTAN BOMB] Really Jimin is elder than Jungkook - BTS (방탄소년단)	QJIS2WNqV7o
[BANGTAN BOMB] BTS with helium-filled Balloon - BTS (방탄소년단)	EenqTqMz7dw
[BANGTAN BOMB] Singing Born Singer - BTS (방탄소년단)	KVnfFKXemrg
[BANGTAN BOMB] SUGA with basketball - BTS (방탄소년단)	DdEgJ_K15r8
[BANGTAN BOMB] Jungkook's sight - BTS (방탄소년단)	-7ifnkZB14g
[BANGTAN BOMB] Jimin's tumbling skill - BTS (방탄소년단)	cb3u-bNbucE
[BANGTAN BOMB] Eye contact with Jin - BTS (방탄소년단)	X1jo1RielMw
[BANGTAN BOMB] HELLO! VJ Jin is back - BTS (방탄소년단)	WNgG_oCIIP4
[BANGTAN BOMB] V's hard dance practice - BTS (방탄소년단)	s_TOJnV4vxU
[BANGTAN BOMB] 태태magazine NEWS - BTS (방탄소년단)	zBnb-CXIr70
[BANGTAN BOMB] Jimin's see-through sleeveless shirt - BTS (방탄소년단)	qLkQWEHZ1A4
[BANGTAN BOMB] Jung kook is drawing "좋아요"	GF1Iru95O78
[BANGTAN BOMB] the happening in Changwon 2 : Icecream match - BTS (방탄소년단)	iI-k9rkZvtY
[BANGTAN BOMB] The happening in Changwon 1 : Watermelon - BTS (방탄소년단)	-8u0bV3P-o0
[BANGTAN BOMB] V's glasses - BTS (방탄소년단)	KMk_zPfJnZI
[BANGTAN BOMB] Jin의 애교 - BTS (방탄소년단)	sEPI62hTjJI
[BANGTAN BOMB] Jung Kook wants to eat a doughnut - BTS (방탄소년단)	ti-OTG2iopw
[BANGTAN BOMB] Cool spray - BTS (방탄소년단)	aXhkPYxPG3s
[BANGTAN BOMB] Kind & Big Lion Styling - BTS (방탄소년단)	zRQHK8oLp2E
[BANGTAN BOMB] VJ Jin Debut! - BTS (방탄소년단)	uYre80nBJxI
[BANGTAN BOMB] 더우시죠? It is hot today, isn't it? - BTS (방탄소년단)	d3RgIc1AW7Y
[BANGTAN BOMB] Tom and Jerry SUGA&Jimin and Jin - BTS (방탄소년단)	ivCTpweEXOM
[BANGTAN BOMB] 지민이의 랩 - BTS (방탄소년단)	zZxVvAc14ZQ
[BANGTAN BOMB] 대기실에서 방탄소년들의 놀이 - BTS (방탄소년단)	194M6u8TkKE
[BANGTAN BOMB] 방탄소년들이 아플 땐? - BTS (방탄소년단)	ZX9B4b-SvEI
[BANGTAN BOMB] 적외선 카메라와의 첫 만남 - BTS (방탄소년단)	AVm3TxaU_Cc
[BANGTAN BOMB] 흥겨운 슙&진&국의 춤사위 - BTS (방탄소년단)	UP4PxLrvPS8
[BANGTAN BOMB] VJ 정국 - BTS (방탄소년단)	ELIOdaJ77lY
