[EPISODE] BTS (방탄소년단) ‘BE’ Jacket Shooting Sketch	dnnxNw2ZZ5o
[EPISODE] BTS (방탄소년단) @ UN General Assembly Speech	zLrTp2KBcWw
[EPISODE] BTS (방탄소년단) @ The Tonight Show	OKy12jb_7EU
[EPISODE] BTS (방탄소년단) @ 62nd GRAMMY Awards	qiuQ1cGGwOA
[EPISODE] BTS (방탄소년단) 'ON' Kinetic Manifesto Film Shooting Sketch	0Dc6tHgXp88
[EPISODE] BTS (방탄소년단) @ 2019 KBS 가요대축제	NWrEs1eUv3I
[EPISODE] BTS (방탄소년단) @ 2018 KBS 가요대축제	jZV1CU95rMo
[EPISODE] BTS (방탄소년단) 'Dynamite' MV Shooting Sketch	BFkh9SgyAMs
[EPISODE] BTS (방탄소년단) @ 2019 SBS 가요대전	es-YzoiNdbc
[EPISODE] BTS (방탄소년단) @ Dick Clark's New Year's Rockin' Eve 2020	Mxu7et015mo
[EPISODE] BTS (방탄소년단) @ 2019 iHR Jingle Ball	0WiOpHXbrYc
[EPISODE] Agust D '대취타' MV Shooting Sketch	KWRJ8CUBsXI
[EPISODE] BTS (방탄소년단) @ 2019 MAMA	7w5DVOMGkoo
[EPISODE] BTS (방탄소년단) @ 2019 MMA	aMhIQVFvyf4
[EPISODE] BTS (방탄소년단) @ 'LOVE YOURSELF : SPEAK YOURSELF’ in SEOUL	fi_mGCVVABc
[EPISODE] BTS (방탄소년단) 'Black Swan' MV Shooting Sketch	hQH1LqAW5FQ
[EPISODE] BTS (방탄소년단) 'ON' MV Shooting Sketch	bYdDxEa3us8
[EPISODE] BTS (방탄소년단) 'MAP OF THE SOUL : 7' Jacket shooting sketch	z2U-IZvqKyU
[EPISODE] BTS (방탄소년단) 'Outro : Ego' Comeback Trailer Shooting	_i1xNKUlGmo
[EPISODE] BTS (방탄소년단) @ 2018 SBS 가요대전	zBb_CcAvHts
[EPISODE] BTS (방탄소년단) ‘Interlude : Shadow’ Comeback Trailer Shooting	WuysD7OTFkY
[EPISODE] BTS (방탄소년단) LOVE YOURSELF 結 'Answer' Jacket shooting sketch	JdLOuSLhuxc
[EPISODE] Welcome to 'BTS POP-UP : HOUSE OF BTS'	wJokJjd-Auw
[EPISODE] 2019 FESTA Family Portrait Shooting #2	PL25mHpsogg
[EPISODE] 2019 FESTA Family Portrait Shooting #1	ocgU3OU90rk
[EPISODE] j-hope 'Chicken Noodle Soup (feat. Becky G)' MV Shooting Sketch	uxG6dIDM5ws
[EPISODE] BTS (방탄소년단) @ Billboard Music Awards 2019	9Dfw8Ly2luo
[EPISODE] BTS (방탄소년단) @ SNL	ZWtFMxxaZW4
[EPISODE] BTS (방탄소년단) LOVE MYSELF Global Campaign Video Shooting Sketch	0gpL4vvgOLQ
[EPISODE] BTS (방탄소년단) @2018 MAMA in HONG KONG	Wkv2zRPef8E
[EPISODE] BTS (방탄소년단) 'MAP OF THE SOUL : PERSONA' Jacket shooting sketch	h0fFr_6sq6w
[EPISODE] BTS (방탄소년단) '작은 것들을 위한 시 (Boy With Luv) feat. Halsey' MV Shooting Sketch	_h5mdGeykP0
[EPISODE] BTS (방탄소년단) @ 2018 MAMA in JAPAN	nvQxTRyPpNk
[EPISODE] BTS (방탄소년단) @2018 MMA	Hi7o-cnmBZU
[EPISODE] BTS (방탄소년단) @2018 MGA	hMUXqTtXbFQ
[EPISODE] BTS (방탄소년단) @2018 대한민국 대중문화예술상	CX-RCQCm04k
[EPISODE] BTS (방탄소년단) UN General Assembly Behind	JeODXwSenKs
[EPISODE] BTS (방탄소년단) 'IDOL' MV Shooting Sketch	boiWgfpYYrk
[EPISODE] BTS (방탄소년단) @ Billboard Music Awards 2018	FBLx-6l24-Q
[EPISODE] BTS (방탄소년단) 'Euphoria : Theme of LOVE YOURSELF 起 Wonder' Shooting	kDKnN42BOiI
[EPISODE] BTS (방탄소년단) LOVE YOURSELF 轉 'Tear' Jacket shooting sketch	YWM1fCHbp-Q
[EPISODE] j-hope 1st mixtape MV Shooting #2	Ip7eVuFxiEE
[EPISODE] j-hope 1st mixtape MV Shooting #1	-viInMgMD3o
[EPISODE] BTS (방탄소년단) @ 2017 SBS 가요대전	R-ceLUo4fgs
[EPISODE] BTS (방탄소년단) @ 2017 MMA	SjFQifUtOIA
[EPISODE] BTS (방탄소년단) @ AMAs 2017	OMjMmULhl_M
[EPISODE] BTS (방탄소년단) 'MIC Drop' MV Shooting	c5_LROaHGtw
[EPISODE] BTS (방탄소년단) LOVE YOURSELF 承 'Her' Jacket shooting sketch	RX5oEl2vpek
[EPISODE] BTS (방탄소년단) 'DNA' MV Shooting	rgRDwhO983s
[EPISODE] BTS (방탄소년단) @ Billboard Music Awards 2017	KAMMRWfrsT8
[EPISODE] BTS (방탄소년단) This is 한성 of '화랑 (Hwa Rang)' (a.k.a. BTS V ^ㅁ^)	s3GNHzN6YGY
[EPISODE] BTS (방탄소년단) 'Not Today' MV Shooting	UZMjLkUJOOU
[EPISODE] BTS (방탄소년단) 'YOU NEVER WALK ALONE' Jacket shooting sketch	46qWWmnK4F0
[EPISODE] BTS (방탄소년단) '봄날' MV Shooting Sketch	hQRSI9DTWio
[EPISODE] BTS (방탄소년단) 'WINGS' Jacket Shooting Sketch	H9LejhGTIYM
[EPISODE] BTS (방탄소년단) @ 2016 MMA	90bCJQdy2G4
[EPISODE] BTS (방탄소년단) 'Save Me' MV Shooting	y_mEk99kDjI
[EPISODE] BTS (방탄소년단) '피 땀 눈물' MV Shooting Sketch	Q2T83o5kNVU
[EPISODE] BTS (방탄소년단) 'Blood Sweat & Tears' Win	dWbpJwnB2VY
[EPISODE] BTS (방탄소년단) FESTA 2016 - Real Family photo Shooting	DAHAUiTjo9A
[EPISODE] BTS (방탄소년단) 'EPILOGUE : Young Forever' MV Shooting	ageimXiZcbs
[EPISODE] BTS (방탄소년단) 'Fire' 1st win @ 160512 M countdown	IZ9ZafuBd-I
[EPISODE] BTS (방탄소년단) '불타오르네 (FIRE)' MV Shooting	DZalBQgECn4
[EPISODE] BTS (방탄소년단)  '화양연화 Young Forever' Jacket Photo Shooting	zrMEKtVQTOk
[EPISODE] BTS (방탄소년단) #BTS1000days with A.R.M.Y	Edtvgd3UwsQ
[EPISODE] BTS (방탄소년단) 'PUMA' Advertising photo shooting behind	ynYiHtE9_Vs
[EPISODE] 방탄소년단 'RUN' MV shooting	ADGpnu_uJqs
[EPISODE] BTS (방탄소년단) '화양연화pt.2' jacket shooting	QjzBTkbxg5c
[BTS NAVER STAR CAST] Halloween party with BTS	RkRiVwR2uBQ
[EPISODE] 'Fantastic 4' with A.R.M.Y	Wn6uLPd-QHM
[EPISODE] 방탄소년단(BTS) '쩔어' Concept photo & MV shooting	xO2KP7aGRrw
[EPISODE] 방탄소년단 'I NEED U' MV shooting	I_QObBbAYNQ
[EPISODE] BTS (방탄소년단) '화양연화pt.1' jacket shooting	2bUjRMt9HUY
[BTS in NAVER STAR CAST] Rap Monster with Warren G (3/3)	1YDq17erYeA
[BTS in NAVER STAR CAST] Rap Monster with Warren G (2/3)	O3YvFibdGSw
[BTS in NAVER STAR CAST] Rap Monster with Warren G (1/3)	7gpXfRwe8wQ
[EPISODE] Rap Monster 'Do You' MV shooting (BTS members supported RM)	Zm4-KJYjb20
[EPISODE] BTS SUGA B-day Present for Fans	inOmCiTAppE
[EPISODE] 'War of Hormone' MV & Photo shooting	N5OulgZOJ-4
[EPISODE] BTS' Summer out of the country in 2014	mw62nvKQwUE
[EPISODE] 방탄소년단 'Danger' MV Shooting	PGhwAJQFjJk
[EPISODE] 방탄소년단 'DARK&WILD' Jacket photo shooting	Y9gL3-D9hqA
[EPISODE] 1st BTS Birthday Party (Jin chef of BTS)	RhJqNFQCU_Q
[EPISODE] BTS (방탄소년단) 1st anniversary - so 4 more	LchUwgPashw
[EPISODE] '하루만(Just one day)' MV shooting Sketch	aO9-0FqR2yo
[EPISODE] Jung Kook went to High school with BTS!	PCjiBaIc1wU
[EPISODE] SUGA Birthday support event	I92iGWGvaaI
[EPISODE] 140218 It's a j-hope-ful day!	gmHSkE8FwP0
[EPISODE] 'Skool Luv Affair' Jacket Photo shooting Sketch	5VgUSjMEcTM
[EPISODE] '상남자(Boy In Luv)' MV shooting Sketch	GQEunnh8MKE
[EPISODE] Be the BEST NEW ARTIST 2013 in Melon Music Awards	LRrMieKVLYA
[EPISODE] BTS Letter to ARMY in Birthday party	dsc4AJKZn7E
[EPISODE] BTS Surprise Birthday Party for Jung Kook!	uav5suskIZM
[EPISODE] BTS (방탄소년단) 'N.O' MV shooting	Ku6VsSAMxuU
[EPISODE] BTS O! RUL8,2? Jacket shooting	5HwJPHACpbk
[EPISODE] BTS (방탄소년단) Like (Showcase sketch)	-wLNpg5IX_g
[EPISODE] 2 COOL 4 SKOOL debut single jacket photo shooting	2GU3OIwwuwA
[EPISODE] BTS (방탄소년단) 2 COOL 4 SKOOL debut single MV shooting	gggl_gMp6H0
[EPISODE] BTS (방탄소년단) Debut day 130613	UPJX6QK6etg
