BTS (방탄소년단) 'Life Goes On' Official MV : in the forest	RvcP6V4h_q4
BTS (방탄소년단) ‘Life Goes On’ Official MV : on my pillow	yIvb4csSgcs
BTS (방탄소년단) Global Press Conference 'BE' (+ENG)	T31mfmw8bS8
BTS (방탄소년단) 'Life Goes On' Official MV	-5q5mZbe3V8
BTS (방탄소년단) 'Life Goes On' Official Teaser 2	t3KZnCgiMW0
BTS (방탄소년단) 'Life Goes On' Official Teaser 1	Wq5S8Dt_HQE
BTS (방탄소년단) 'Dynamite' Official MV (Choreography ver.)	BflFNMl_UWY
BTS (방탄소년단) 'Dynamite' Official MV (B-side)	BV2FdDmGiW0
BTS (방탄소년단) 'Dynamite' Official MV	gdZLi9oWNZg
BTS (방탄소년단) 'Dynamite' Official Teaser	oxoWhyS9buA
BTS (방탄소년단) 'Stay Gold' Official MV	9IHwqdz8Xhw
[2020 FESTA] BTS (방탄소년단) 'We are Bulletproof : the Eternal' MV #2020BTSFESTA	7UWBYJjuIL0
Agust D '대취타' MV	qGjAWJ2zWWI
BTS (방탄소년단) 'Black Swan' Official MV	0lapF4DQPKQ
BTS (방탄소년단) 'ON' Official MV	mPVDGOVjRQ0
BTS (방탄소년단) 'ON' Kinetic Manifesto Film : Come Prima	gwMa6gpoE9I
BTS (방탄소년단) MAP OF THE SOUL : 7 'Outro : Ego' Comeback Trailer	LmApDbvNCXg
BTS (방탄소년단) 'Black Swan' Art Film performed by MN Dance Company	vGbuUFRdYqU
BTS (방탄소년단) MAP OF THE SOUL : 7 'Interlude : Shadow' Comeback Trailer	PV1gCvzpSy0
방탄소년단 No More Dream (Bus scene long take ver.)	CInMhOtzb3U
BTS (방탄소년단) O! RUL8,2? Preview	BfVt5jRGWCo
BTS (방탄소년단) Skool Luv Affair Preview	iWCGayIOEGQ
BTS (방탄소년단) 가요대제전 Intro performance Trailer	S1Up-ZzHmuw
BTS (방탄소년단) 2015 BTS LIVE TRILOGY: EPISODE I. BTS BEGINS Official Teaser	VpVU06dbTIw
BTS (방탄소년단) 화양연화 pt.1 Preview	Smmx-FzT3DQ
BTS (방탄소년단) 화양연화 pt.2 Preview	ZUg0mRpU-hk
BTS (방탄소년단) LOGO ANIMATION	qx27yTK_KXw
BTS (방탄소년단) 'Danger' Official Teaser #2	5dziTIhZ15w
BTS (방탄소년단) 'I NEED U' Official Teaser	Jds9ktFqh8s
BTS (방탄소년단) 'Make It Right' Official MV (Vertical ver.)	y3rj2CDHF5c
BTS (방탄소년단) 'Make It Right (feat. Lauv)' Official MV	eXBu09fwe3I
j-hope 'Chicken Noodle Soup (feat. Becky G)' MV	i23NEQEFpgQ
BTS 'Lights' Official MV	eaUpme4jalE
BTS (방탄소년단) '작은 것들을 위한 시 (Boy With Luv) (feat. Halsey)' Official MV ('ARMY With Luv' ver.)	62E_xyj_oDA
BTS (방탄소년단) '작은 것들을 위한 시 (Boy With Luv) (feat. Halsey)' Official MV	XsX3ATc3FbA
BTS (방탄소년단) '작은 것들을 위한 시 (Boy With Luv) (feat. Halsey)' Official Teaser 2	1zDd-3J1nTg
BTS (방탄소년단) '작은 것들을 위한 시 (Boy With Luv) (Feat. Halsey)' Official Teaser 1	jrSsNzsi4eQ
BTS (방탄소년단) MAP OF THE SOUL : PERSONA 'Persona' Comeback Trailer	M9Uy0opVF3s
BTS (防弾少年団) 'Airplane pt.2 -Japanese ver.-' Official MV	CxnJf0tWu48
RM 'moonchild' Lyric Video	G9ntaxClfrA
RM 'seoul (prod. HONNE)' Lyric Video	F8wI5ZosdRA
RM 'forever rain' MV	Cvb76hBX_Oc
BTS (방탄소년단) 'IDOL (Feat. Nicki Minaj)' Official MV	K1scjjbfNsk
BTS (방탄소년단) 'IDOL' Official MV	pBuZEGYXA6E
BTS (방탄소년단) 'IDOL' Official Teaser	Rd0UqlRf1eE
BTS (방탄소년단) LOVE YOURSELF 結 Answer 'Epiphany' Comeback Trailer	fIkZOLsnoqY
BTS (방탄소년단) 'FAKE LOVE' Official MV (Extended ver.)	D_6QmL6rExk
BTS (방탄소년단) 'FAKE LOVE' Official MV	7C2z4GqqS5E
BTS (방탄소년단) 'FAKE LOVE' Official Teaser 2	2tDKp41nrw8
BTS (방탄소년단) 'FAKE LOVE' Official Teaser 1	BP71K87Hp5Y
BTS (방탄소년단) LOVE YOURSELF 轉 Tear 'Singularity' Comeback Trailer	p8npDG2ulKQ
BTS (방탄소년단) 'Euphoria : Theme of LOVE YOURSELF 起 Wonder'	kX0vO4vlJuU
j-hope 'Airplane' MV	8O_MwlZ2dEg
j-hope 'Daydream (백일몽)' MV	OK3GJ0WIQ8s
BTS (防弾少年団) 'MIC Drop -Japanese ver.-' Official MV	8mBHDHIb-kM
BTS (방탄소년단) 'MIC Drop (Steve Aoki Remix)' Official MV	kTlv5_Bs8aw
BTS (防弾少年団) 'MIC Drop -Japanese ver.-' (Short ver.) Official MV	TxyHwwYe86Q
BTS (방탄소년단) 'MIC Drop (Steve Aoki Remix)' Official Teaser	ixxR3ZoqnF0
BTS (방탄소년단) 'DNA' Official MV	MBdVXkSdhwU
BTS (방탄소년단) 'DNA' Official Teaser 2	g_wuoInNyAI
BTS (방탄소년단) 'DNA' Official Teaser 1	FSOxXsYVJMQ
BTS (방탄소년단) LOVE YOURSELF 承 Her 'Serendipity' Comeback Trailer	BEMaH9Sm3lQ
BTS (방탄소년단) LOVE YOURSELF Highlight Reel '起承轉結'	EHdK5U2hf4o
BTS (방탄소년단) LOVE YOURSELF Highlight Reel '轉'	Oj-zYDbw1Co
BTS (방탄소년단) LOVE YOURSELF Highlight Reel '承'	o75Y9XWLY9M
BTS (방탄소년단) LOVE YOURSELF Highlight Reel '起'	Oqksx-xkSg8
BTS (防弾少年団) '血、汗、涙 -Japanese Ver.-' Official MV	7OX7dIRReSA
BTS (防弾少年団) '血、汗、涙 -Japanese Ver.-' Official Teaser	Bbq-XZOoSYw
RM, Wale ‘Change’	9rAyprZdo7o
BTS (방탄소년단) 'Not Today' Official MV (Choreography Version)	nKDppUjuvdM
BTS (방탄소년단) 'Not Today' Official MV	9DwzBICPhdM
BTS (방탄소년단) '봄날 (Spring Day)' Official MV	xEeFrLSkMm8
BTS (방탄소년단) 'Not Today' Official Teaser	w-9GwVG83nQ
BTS (방탄소년단) '봄날 (Spring Day)' Official Teaser	fUZlQGxsnJY
BTS (방탄소년단) '피 땀 눈물 (Blood Sweat & Tears)' Official MV	hmE9f-TEutc
BTS (방탄소년단) '피 땀 눈물 (Blood Sweat & Tears)' Official Teaser	iEjqStYLyVQ
BTS (방탄소년단) WINGS 'Boy Meets Evil' Comeback Trailer	iJJSh-eEdRk
BTS (방탄소년단) WINGS Short Film #7 AWAKE	WYbrLlVelYk
BTS (방탄소년단) WINGS Short Film #6 MAMA	wu82g0vyyTY
BTS (방탄소년단) WINGS Short Film #5 REFLECTION	wzxjM-82RW8
BTS (방탄소년단) WINGS Short Film #4 FIRST LOVE	7VPcnJ9oJ-k
BTS (방탄소년단) WINGS Short Film #3 STIGMA	3i34dFsjRY4
BTS (방탄소년단) WINGS Short Film #2 LIE	_y8-HD5O69g
BTS (방탄소년단) WINGS Short Film #1 BEGIN	yR73I0z5ms0
Agust D ‘give it to me’ MV	_Zgc12yL5ss
Agust D 'Agust D' MV	3Y_Eiyg4bfk
BTS (방탄소년단) 'Save ME' Official MV	GZjt_sA2eso
BTS (방탄소년단) '불타오르네 (FIRE)' Official MV	4ujQOR2DMFM
BTS (방탄소년단) '불타오르네 (FIRE)' Official MV (Choreography Version)	2cTZTqBU1Rc
BTS (방탄소년단) '불타오르네 (FIRE)' Official Teaser	QH7LfLSVoW0
BTS (방탄소년단) 'EPILOGUE : Young Forever' Official MV	LbvE0FV_70U
BTS (防弾少年団) 'RUN -Japanese Ver.-' Official MV	a16gTN7kOWU
BTS (防弾少年団) 'I NEED U (Japanese Ver.)' Official MV	LYAcYSmaLoc
BTS (방탄소년단) 'RUN' Official MV	wKysONrSmew
BTS (방탄소년단) 'RUN' Official Teaser	eIUum9MFlD4
BTS (방탄소년단) 화양연화 pt.2 'Never Mind' Comeback Trailer	LOadwTF77tw
BTS (방탄소년단) 화양연화 on stage : prologue	Bt8648TNX1M
BTS (방탄소년단) '쩔어' Official MV	H8lYMWZD5P8
BTS (防弾少年団) 'FOR YOU' Official MV (Dance Ver.)	ULStzgQYrqk
BTS (防弾少年団) 'FOR YOU' Official MV	TTG6nxwdhyA
BTS (방탄소년단) 'I NEED U' Official MV (Original ver.)	jjskoRh8GTE
BTS (방탄소년단) 'I NEED U' Official MV	DOuhvBJqKVY
BTS (방탄소년단) 화양연화 pt.1 '花樣年華' Comeback Trailer	IW-ZUAUWgwo
Rap Monster '농담' MV	TfenCTabhDY
Rap Monster x Warren G 'P.D.D' MV	WFArWe1MLW8
'Danger (Mo-Blue-Mix) ft. THANH' MV	3Wz-KiqFXGc
'Danger (Mo-Blue-Mix) ft. THANH' Teaser	7Jv2xp-6m_A
BTS (방탄소년단) '호르몬전쟁' Official MV	Hhph0_CdUHg
BTS (방탄소년단) 'Danger' Official MV	43r6lXilbcQ
BTS (방탄소년단) 'Danger' Official Teaser #1	qSL6ne_7V4k
BTS (방탄소년단) DARK & WILD 'What Am I To You' Comeback Trailer	_3OLpHsAR54
BTS(방탄소년단) Comeback Trailer	R_nfKfAnZ2A
BTS (방탄소년단) '하루만 (Just one day)' Official MV	dzAwJW107nk
BTS (방탄소년단) '하루만 (Just one day)' Official Teaser	MtidUkuu3gU
BTS (방탄소년단) '상남자 (Boy In Luv)' Official MV (Choreography Version)	4XyPdnTz_Q0
BTS (방탄소년단) '상남자 (Boy In Luv)' Official MV	LHHjp3IMjMk
BTS (방탄소년단) '상남자 (Boy In Luv)' Official Teaser	OCxBOgjZc6s
BTS (방탄소년단) Skool Luv Affair 'Skool Luv Affair' Comeback Trailer	4lKeF2CDGbk
BTS (방탄소년단) 'N.O' Official MV	r5GaAEHvHj0
BTS (방탄소년단) 'N.O' Official Teaser #2	GYDncRcwdlE
BTS (방탄소년단) 'N.O' Official Teaser #1	R3017eEgykw
BTS (방탄소년단) O!RUL8,2? Comeback Trailer	DHAk3T_gqBQ
방탄소년단 Comeback trailer	fglrRHHSO7A
BTS (방탄소년단) 'We Are Bulletproof Pt.2' Official MV	lE9lkSdtZeQ
[MV] BTS(방탄소년단) _ No More Dream (Dance ver.)	pUkViXyQTI4
[MV] BTS(방탄소년단) _ No More Dream(노 모어 드림)	pw540DtB5mM
BTS (방탄소년단) 'No More Dream' Official MV (Choreography Version)	l15_-4-_QO8
BTS (방탄소년단) 'No More Dream' Official MV	rBG5L7UsUxA
BTS (방탄소년단) 'No More Dream' Official Teaser #2	f7rUjOadhwo
BTS (방탄소년단) 'No More Dream' Official Teaser #1	ZjEnJif3mGM
BTS (방탄소년단) Debut Trailer	Ya65AfxLesU
