✨저희는 그래미 노미네잇 B.T.S라고 합니다✨ #GrammyNominatedBTS	25RyPQ9XtxE
[방탄소년단/BTS] 복붙소년단 | Ctrl+C Ctrl+V	7A7ygDqV3JE
[방탄소년단/진&지민&정국] 빠져나올 수 없는 지진정의 늪	MjrU-FQpoRo
[방탄소년단/BTS] 롯데면세점 패밀리 콘서트 2020 BTS 편집본 | Lotte Duty Free Family Concert 2020 BTS CUT	Qo0B7v39Ofo
[방탄소년단/지민&뷔] 구오즈의 환상적인 특급케미| JIMINxV	RIix_a-STtU
[방탄소년단/정국] 이게 바로 하이텐션 전.정.국 | 우리집 아이입니다!	f7VbnR280Uo
[방탄소년단/BTS] 방탄소년단이 신서유기 출연!?	tooOfLhFr7g
[방탄소년단/BTS] 카운트다운 다시보기	93b62gfYhAk
[방탄소년단/BTS] 선배미 뿜뿜 방탄소년단이 알려주는 키포인트 | 지금까지 이런 강의는없었다!	81VYGQVCM4g
[방탄소년단/BTS]  귀염미 뿜뿜 방탄소년단의 펜트하우스 탐방기 | 20200814 I-LAND 방탄소년단 CUT	DjIGgPlkq0k
[방탄소년단/진&지민&뷔&정국] We are Bulletproof PT1 |삭제된 클립영상 다시보기 | 보컬라인의 안 흔한 랩실력	tCqRVevtzzU
[방탄소년단/BTS] 👻겁쟁이소년단모음👻 | 겁이 많은 자여 여기로	pJjh0vtKhQY
[방탄소년단/진] 진의 아재개그 모음 피식하면 지는 거다 (feat.SUGA)	kGlRJCmGdKw
[방탄소년단/뷔] 귀여워 사랑스러워 태태어 | CUTE LOVELY and Tae Tae Language	cEvzWw4L6_A
[방탄소년단/지민] 지민이의 귀여운 순간 모음② | BTS JIMIN cute moment | #2020상반기달방모음	l1F2fY16r_w
[방탄소년단/BTS] EP.01 위기탈출넘버원 딸기편! | 방탄 옛날영상 다시보기 | 방탄이즈백	oHjP0yhCWBw
[방탄소년단/지민] 지민이의 귀여운 순간 모음① | BTS JIMIN cute moment | #2020상반기달방모음	AiXUwUynxEs
[방탄소년단/BTS] 흥(많이)탄소년단 특집 | 웃음참기끝판왕 | 웃으면 앞이 안보이더라 웃으면 안돼~	pefzCS6dqUQ
[방탄소년단/지민] 🐥왕말랑깜직요정천사 지민이의 큐트 러블리 모먼트🐥| JIMIN CUTE LOVELY MOMENT	Kxd-0qfAoP0
[방탄소년단/뷔] 태형이의 귀여운 순간 모음② | BTS V cute moment | #2020상반기달방모음	wyJ-d8njOp8
[방탄소년단/진&슈가&RM&정국] 𝘼𝙜𝙪𝙨𝙩 𝘿와 함께 작업할 썰| 천국행 정국가이드| 마무리는 삼행시	xYg8KAs3iw0
[방탄소년단/뷔] 태형이의 귀여운 순간 모음① | BTS V cute moment | #2020상반기달방모음	OK3wh3VM-vk
[방탄소년단/정국] 정국이의 귀여운순간 모음② | BTS JK cute moment | #2020상반기달방모음	nPEULnCJjIs
[방탄소년단/정국] 정국이의 귀여운순간 모음① | BTS JK cute moment | #2020상반기달방모음	YvaY-Nk9ShU
[방탄소년단/BTS] 엉덩이가 들썩들썩 방탄동요모음 | 방탄유치원 보라반 모여라	hCyH2VHlKEA
[방탄소년단/슈가&지민] 미니미즈의 환상적인 특급케미| SUGAxJIMIN	pwztjOraOEw
[방탄소년단/BTS] 영원히 고통받는 방(탄)(바)보	uZMX8QVammk
[방탄소년단/BTS] EP01.방탄100초인터뷰 | 옛날영상 다시보기 | 방탄이즈백시리즈	gESCgt7vMzU
[방탄소년단/진&슈가] 구룸메즈의 환상적인 특급케미 | JINxSUGA	STPHDcgoEDw
[방탄소년단/BTS] 방탄소년단과 함께하는 심리테스트!	wNmBrpTw2hA
[방탄소년단/RM&지민]  미니모니가 쏘아올린 달고나커피☕️	YCM7EVH3TIw
[방탄소년단/지민&뷔] 보이스뷔(V)싱 | 95's 상황극 |	lu5AuPbv4AE
