JINKOOK - Cute and Funny Moments	SBRlZrivYqc
BTS Kim Taehyung - Cute and Funny Moments	iCQ8UvwNfu0
BTS Funny Moments 2019 Try Not To Laugh Challenge	Y8Vg4t6p9uk
BTS Jungkook is still a baby #GoldenMaknae	hmjB5IgCjqY
BTS Kim Taehyung - Cute and Funny Moments 2020	MFFAym4Sjug
BTS You laugh = You lose Challenge 2020	hANoMuzGLRY
Don't fall in love with BUSAN BOYS (Jimin & Jungkook) Challenge!	MO-RJVy_xw8
BTS Funny Moments With Water #BTSFunnyMoments	tDBRxx176iE
BTS & BigHit staff sweet moments #BTSCuteMoments	OCu057cJSRc
BTS - Try Not to Laugh Challenge! #BTSFunny2020	2D6vj83vNR0
Jungkook being himself	o4SyvbZv2Qw
BTS Funny Moments COMPILATION	5m6hPArwic0
Don't fall in love with Kim Taehyung Challenge!	eCHbOcZcQOU
When you can't understand JIN (ì§„ BTS)	--I6ih93puw
BTS Funny and Extra moments :)	0PUoNQBaXys
Everyone needs JIMIN in their lives)	O_krq7FuHyg
BTS Funny Moments (2020 COMPILATION)	lsB5Lh6XUDY
Don't fall in love with SUGA Challenge! :)	KtDxgdVa0IM
11 MINUTES OF BTS' SILLINESS	IAzYwQO4ric
Everyone needs TAEHYUNG in their lives!!	w_N7xRFVfLY
BTS JUNGKOOK CUTE AND FUNNY MOMENTS	YCN_C_BgCbc
BTS never fail to make you laugh!	OSojc6D3yQk
BTS making your day better for 11 minutes straight	zMMl37O0QmQ
Don't fall in love with Jin (BTS) Challenge!	PgTcrAHKWmk
BTS SUGA being himself :)	VHHHsuxyOVQ
BTS JIMIN being himself :)	E7Cc4k6sNTY
BTS being comedians (you laugh = you lose)	txR6e_CDX9Q
BTS Taehyung being himself	a8ALhgXfpn4
Private video	QMRIapKReXc
A Video To Watch When You're Sad BTS Version	y2cATQOS7Cs
Everyone needs JUNGKOOK in their lives!!	2eY2YkCGaqw
BTS JIN being himself	EEEwcoO9EB0
A Video To Watch When You're Sad Taehyung Version	C4cFlU9CwiI
Don't fall in love with JiHope (Jimin & J-Hope) Challenge!	Q1FidNeG9As
BTS RM being himself	IeqZU4Bv-HE
BTS Eating Moments	yWK3hwkdxFc
BTS Being Silly Together (BTS Funny Moments)	RuNP19gqoMk
Jungkook cute moments Try Not To Smile Challenge	JVOYiYTEwow
BTS being scared :)	5nLrceJCvUI
BTS JUNGKOOK makes his hyungs laugh! :)	tEOCIkAqA8g
Best of BTS VMIN (Jimin & Taehyung)	n172ggf7Uwo
Deleted video	WrzL0wEzqHw
BTS Try Not To Laugh (You Laugh = You Lose) Challenge!	Jiy7K4GJMgE
A Video To Watch When You're Sad Jimin Version	nNb9Bi-Ercc
Don't fall in love with MAKNAE LINE Challenge!	RQngwJD8NwE
