BE promotions are WILD so far	rdyntX935gA
bts being questionable (try not to laugh)	vBJgThKtkxo
the S in BTS stands for S N I T CH	2jPtq6nm-v4
the b in bts stands for betrayal	8G5GMhjbrj0
bts betraying each other for 5 min	nfdsh-_B8jY
Private video	M9mpOanERl8
bts being nothing but I C O N I C (try not to laugh)	P_eSetOGlUU
BTS moments that are kdrama worthy (try not to laugh)	QDOdItI5-kI
bts making me question their sanity	HbkAd14Gg0A
bts ending comedians careers	011YML19z_U
bts invented comedy (you laugh = you lose)	O1A_jXlf0Fs
bts' comedy show continues	6Eu9inFnUuE
bts doing weird things again (try not to laugh)	vU2WxqzOWwo
questionable things bts does for no apparent reason	NcUgr1HraEU
chaotic af bts clips to get you through the day	RSS29FCmJ_M
bts being the hilarious icons they are	0FNhwcItnhQ
BTS initiating their full-on crazy mode	sAlRT4HIChs
bts your not so average clowns	KcLDeHOleaQ
when bts .exe has stopped working	8FAJjEWHmmA
bts finally losing it (try not to laugh)	5DYkQTO9i2M
BTS the original chaos squad	GZo6noTcf_g
bts kitchen disasters (do not try this at home)	0-yNwYGUkHg
bts full-on crazy mode	3V2zgWYVeDA
bts said 'watch me bring the chaos'	rf-pM1lCJiU
bts still a huge mess in 2020	-gYr3ybmw-0
bts said the chaos goes on	26qFi4dwe00
bts clips that had me bust a lung (try not to laugh)	TJ_vJBH13QE
how bts invented comedy (try not to laugh)	MidJbXHWqYs
bts said bring the chaos	yqKSQEt8WPM
bts dynamite era is quite messy so far (try not to laugh)	L9uaRvaO77U
bts chaos to get you through quarantine	dKCbheCDYTg
