Video you need to watch if you Miss Min Yoongi	6pNtcisyX0k
Jeon Jungkook's Love for Food	IcRHUgd_u3I
Park Jimin's Love for Alcohol	cVLoub02ivQ
Taehyung's Love for Strawberries	8ADtd_AQ7Aw
Jhope's Love for Sprite	5CCVoh7ioB4
Min Yoongi's Love for Coffee !	EzmQkUoBsVU
Kim Seokjin's Love for Gummy Jelly	mk39vAEq7QE
Kim Namjoon's [김남준] Level of Patience with BTS Part 1 | Reupload	JbzFen3a3Bs
Namjoon Hating Mint Chocolate for 7 minutes straight (ft Jin) !	wQ4-VY7SkTk
‘S’ in Suga Stands for Shy Boy Suga | Yoongi Getting Shy	MYBZvy6GQuM
BTS Invented Roleplaying  | Eng Sub |	3iqifISbVGc
Jeon Jungkook Being Relatable | Eng Sub |	oUoeQ019xMQ
Jhope is the King of Organization and Cleaning.	QKnb5bkKVvQ
If Comfort Was a Person, It'd be Park Jimin | Happy Birthday Jimin 2020 |	qxHExeBvRFk
Just BTS Driving	tM8T5Q0yEr0
Namgi ( Namjoon & Yoongi) : 10 Years of Living Together	cD7GNlDKGkg
Namseok /94s ( Namjoon & JHope)  & Their Precious Bond	jDQo49KjaVA
The Little One & His Suga Hyung | Yoonkook [Yoongi & Jungkook] : Part 1	jyb3NdddIWQ
No Worries, At Least This Planet Has Namjoon | Happy Birthday Kim Namjoon |	u4yf-r28S0U
Park Jimin : Hyung of The Maknae Line	fuJTw20N7AY
Jeon Jungkook Being The Best Maknae: The Obedient Youngest Brother.    #HappyJungkookDay	1SV2d53Vs_s
Everyone Gangsta Until Taehyung Speaks in Tiny English	TbfYVyKltFk
How to stream BTS' New Single Dynamite.	d4WHoBkJJ4I
Kim Taehyung Speaking in Tiny : Part 1	BUxYa_-PaB0
J-Hope Being Dramatic & Extra: A Cutest Saga	eRz7OmTKULI
Oscar Worthy Acting by BTS	cXxCMP_LI-Q
Love Yourself - A Lesson by Park Jimin [박지민]	847mJNFnQ0c
Kim Taehyung [김태형] : BTS' Genius| Part 2 | Re-upload| Eng Sub|	EB9rX9db6FE
Kim Namjoon's [김남준] Level of Patience with Everything:  Part 2	rb2lPXO69Kk
Kim Namjoon's [김남준] Level of Patience with BTS Part 1 | Eng sub |	owohj_bruOE
Clueless Jhope [ 정호석] | Eng Sub | Re-upload	1jkpaZE0H-w
Kim Seokjin [김석진 ] Being the Smart, Wise & Intellectual Man That He Is | eng sub|	VuqbVvdrxDE
Kim Seokjin [김석진 ] Being the Smart, Wise & Intellectual Man That He Is | eng sub|	VuqbVvdrxDE
2Seok [Kim Seokjin & Jung Hoseok] : The Cutest & Chaotic Duo Together | Part 2| Re-Upload	BNpk14H-Nn0
2Seok [Kim Seokjin & Jung Hoseok] : The Cutest & Chaotic Duo Together | Part 2| Re-Upload	BNpk14H-Nn0
2Seok [Kim Seokjin & Jung Hoseok] : The Cutest Duo Together | Part 1| Re-Upload |	lvJwX9p5iJs
2Seok [Kim Seokjin & Jung Hoseok] : The Cutest Duo Together | Part 1| Re-Upload |	lvJwX9p5iJs
Min Yoongi's/Suga's Random Knowledge| Yoongipedia | Eng Sub |	_r9iGXpmm78
Min Yoongi's/Suga's Random Knowledge| Yoongipedia | Eng Sub |	_r9iGXpmm78
Min Yoongi [민윤기] Whining & Pouting like a Baby | Eng Sub |	92311ZR69hg
Hopekook : Jungkook is J-hope' Baby | Eng Sub |	ZjlFwXX5w_g
Jhope [Jung Hoseok] : An Invaluable Member of BTS | Hobi's Birthday Video [Re-upload]	5urbq-Sy_w8
Kim Seokjin [김석진] Being BTS' Baby | Eng Sub |	bF1o_kQNlcA
'We are Bulletproof : the Eternal' | 7 Years With BTS	0tri3Y53UG8
NamJin ( Namjoon & Jin ) : Sharing Their One Braincell | Eng Sub |	dVWC8FEt9LM
Kim Taehyung [김태형 ] Hates Losing | Eng Sub |	3KjMpwzvfYw
Chef Min Suga [슈가] | ENG SUB| : Updated Version	ZAeiDrvhdFs
Jeon Jungkook Being The Best Boy That He is ! ENG SUB !	E-DmUEvaKsU
Kim Namjoon : The Maknae of the Hyung Line Part 2  |Eng Sub|	NaECPIsmIAE
Kim Namjoon : The Maknae of the Hyung Line Part 1 |Eng Sub|	-joMRCZ68jA
Min Yoongi Let BTS do Anything to Him [ His Endless Patience with BTS]	o83cuKn7SGg
Park Jimin [박지민] Your Favourite Slytherin | Eng Sub|	CjsHzrd8b0c
Kim Seokjin [김석진] : Your Favorite Comedian Part 2 | Eng Sub|	GtyNi5U8Ys4
Chef Min Suga [슈가] | ENG SUB| : Re-Upload	hs10s2hqr6k
Kim Seokjin [김석진] : Your Favorite Comedian Part 1 | Eng Sub|	ihzDfjDeSqE
Hopekook (J-Hope and Jungkook) : Jungkook is J-Hope's Baby |Eng Sub|	qRF5TRV46kU
Friends [친구] by VMIN [Taehyung & Jimin] : 7 Years of History	7qOEESWc-QI
BTS' MAKNAE LINE  [방탄소년단 ] |ENG SUB|	UmVOaa_sJCw
Min Yoongi Speaking English in Tiny Fonts |Eng Sub|	lg0sB8mcw8Q
BTS Being Chaotic [방탄소년단 ]  | Part 2 | ENG SUB |	9iRrpcBWZNw
Jeon Jungkook [전정국] and His Wise Little Philosophies | Eng Sub |	t6HaTjZXCbU
Min Yoongi's Words of Wisdom | Happy Birthday to Min Yoongi |민윤기 /Min Suga	-78yGMezUQA
2Seok [Kim Seokjin & Jung Hoseok] : The Cutest Duo Together | Part 1|	ES6zNyOSiyA
Jhope [Jung Hoseok] : An Invaluable Member of BTS | Hobi's Birthday Video [Re-upload]	4V_WomgZIs4
J-Hope Speaking English in Tiny	A482ZLI4vDk
BTS' HYUNG LINE [방탄소년단 ] |ENG SUB|	GdL94KRb0Ag
Min Yoongi's/Suga's Random Knowledge| Yoongipedia | Eng Sub |	G_iyLggLRHI
Kim Taehyung [김태형] and Game of UNO ! [ENG SUB]	LSF-n-vvygE
The Curious Case of Clueless J-Hope [정호석] | ENG SUB |	aChafjkIsb8
Kim Seokjin [김석진 ] and His Dad Jokes | ENG SUB|	UPH8TjDCzWM
Kim Taehyung [김태형] : BTS' Genius| Part 2 | Happy Birthday Taehyung | Eng Sub|	Qo0RC1bm3zM
Kim Taehyung [김태형] - BTS' Underrated Genius [ Part 1] | ENG SUB |	keaACw5lRMM
Min Yoongi [민윤기] and His Dry Sense Of Humor | ENG SUB | Reupload	Bbl9ocLixYs
Worldwide Jinius : Kim Seokjin  [김석진] from BTS [방탄소년단]	Evz3DC-4bxc
Shit BTS Min Yoongi (민윤기) Says |Eng Sub| Re-Upload	yYGU0WsAjZc
King of Cheating and Sabotaging BTS - Min Yoongi (민윤기) |Eng Sub|	IlQiE_1uj_0
A Chaotic Duo : Yoonjin ( Min Yoongi & Kim Seokjin)	Bc03u4Rs-Bg
Most Relatable Idol Ever - BTS Min Yoongi (민윤기) |Eng Sub|	cTYnzThxR40
Shit BTS Min Yoongi (민윤기) Says |Eng Sub|	d1jzuQP2I8c
Savage and Iconic Lines by Kim Seokjin [김석진]	FPD7xhl699Y
The Cake Fairy of BTS - Park Jimin [ 박지민 ] | Happy Birthday Jimin |	Hv0_PeuzN4M
The History of Team Kim Seokjin [ 김석진 팀 ] | [ ENG SUB ]	Lw0Sb0EmDOQ
Jeon Jungkook [전정국] and His Eternal Love for Food | Re-Upload with new content	iSv_l91oAlM
J-Hope's Biggest Fanboys - BTS (방탄소년단)	aaalLNaOkNg
Jeon Jungkook [전정국] and His Eternal Love for Food | Happy Birthday Jungkook |	HCLZtjDEmIY
J-Hope (방탄소년단) : King of Sound Effects !	eZJhcle864Q
Kim Seokjin (김석진 BTS) Laugh Compilation [2019] | Eng Sub	goW597AO3oY
Wise Words That Helped ARMYs From Kim Namjoon (김남준) | Happy Birthday RM 2019 | Eng Sub|	RP3rPGHMOhI
HEARTBEAT (BTS World OST) but its SAVE ME Webtoon	xyRc6Ucpivg
